Noms 	Formes usuelles	Syriaca ID	Rôles	Remarks for SYRIACA	Remarks for eKtobe
120 martyrs 	ܡ̈ܐܐ ܘܥܣܖ̈ܝܢ ܣܗܕ̈ܐ		Saint		
24000 martyrs de Magdala			Saint		
40 martyrs de Sébaste	ܐܪ̈ܒܥܝܢ ܣܗ̈ܕܐ ܘܩܕ̈ܝܫܐ ܒܣܐܒܣܛܝܐ ܡܕܝܢܬܐ		Saint		
Aaron bar Yuḥanon bar Ḥasan (16 s.)	ܐܗܪܘܢ		famille du copiste		
Aaron de Saroug (†337) 	ܐܗܪܘܢ 		Saint		
Abbé Morel (17 s.)			copiste		
Abd al-Aḥad (†1895)	عبد الاحد		autre		
Abd al-Aḥad (17 s.)	ܥܒܕ ܐܠܐܚܕ		Copiste		
Abd al-Aḥad de Mardin (18 s.)	ܥܒܕ ܐܠܐܚܕ		Commanditaire		
Abd al-Aḥad ibn Dawud (17 s.)	Dominique David ܥܒܕ ܐܠܚܕ ܒܢ ܕܐܘܘܕ		Copiste		
Abd al-Aḥad ibn Ḥana (18 s.)	ܥܒܕ ܐܠܐܚܕ		Copiste		
Abd al-Aḥad ibn Ni'matallah, neveu du prêtre Rabban ʿAbdallah al-Gul de Mardin (17 s.) 	ܐܠܥܒܕ ܐܠܐܚܕ ܐܒܢ ܢܥܡܗ̈ ܐܒܢ ܐܟܘ ܪܒܐܢ ܥܒܕ ܐܠܠܗ ܐܠܓُܘܠ ܡܢ ܡܐܪܕܝܢ		Copiste		
Abd al-Aziz bar Giwargis d'Aḥbob (19 s.)	ܥܒܕ ܐܠܥܙܝܙ ܒܪ ܓܘܪܓܝܣ		Restaurateur ; copiste		
Abd al-Masiḥ ibn ʿAbd al-Nūr al-Samandari (17 s.) 	ܥܒܕ ܐܠܡܣܝܚ ܒܢ ܥܒܕ ܐܠܢܘܪ ܐܠܣܡܢܕܐܪܝ		Commanditaire		
Abd al-Nur ibn Ya‘qub	ܥܒܕ ܢܘܪ ܐܒܢ ܝܥܩܘܒ		Copiste / Propriétaire précédent		
Abd al-Ṣaliḥ ibn ‘Abd al-Qudus			Saint		
Abda da-Mšiḥa († 384)	ܥܒܕܐ ܕܡܫܝܚܐ 		Saint		
Abdallah de Ḥiṣn Kifa	ܥܒܕ ܐܠܠܗ		lecteur		
Abdallah de Mardin (début 17 s.)	ܥܒܕܐܠܠܗ		Relieur		
Abdišo' (18 s.)	ܥܒܕܝܫܘܥ		Annotateur		
Abdišo' (fin 18 s.)	ܥܒܕܝܫܘܥ		Relieur		
Abdišo' bar Dawid bar Šem'udin de Bet 'Awire	ܥܒܕܝܫܘܥ		Propriétaire précédent		
Abdišo' bar Eša'ya (18 s.)	ܥܒܕܝܫܘܥ ܒܪ ܐܫܥܝܐ		Copiste 		
Abdišo' de Gazarta (16 s.)	ܥܒܕܝܫܘܥܕܓܙܪܬܐ	311	Auteur		
Abdišo' de Nisibe († 1318)	 'Abdišo' bar Brika ; 'Abdišo' de Ṣoba et d'Arménie ; 'Ebed Yešu'ܥܒܕܝܫܘܥ ܕܨܘܒܐ ܘܕܐܪܡܢܝܐ	310	Auteur		
Abdišo' le Solitaire	ܥܒܕܝܫܘܥ	Needs ID	auteur		
Abdišo' V Giwargis Khayyat  (1827-1899)	 Catholicos d'Orient Métropolite chaldéen d'Amid Métropolite chaldéen de Mossoul ܥܒܕܝܫܘܥ ܓܝܘܪܓܝܣ  ܟܝܝܬ 		Commanditaire, Copié du temps, Copiste du modèle, Proprétaire		
Abdišo’ bar Kanun (18 s.) 	 'Ebedyešua' ܥܒܕܝܫܘܥ ܒܪܟܰܢܘܢ		Commanditaire		
Abdmšiḥa de Ḥirta (10-11 s.)	ܥܒܕܡܫܝܚܐ	Needs ID	Auteur		Is this http://syriaca.org/person/889 ? See Assemani's note. http://digitale-sammlungen.ulb.uni-bonn.de/content/pageview/33577
Abdo et Abdišo’ (†374-375)	ܥܒܕܐ, ܥܒܕܝܫܘܗ		Saint		
Abdochos de Mélitène (12 s.) 	 Eudochus ܐܒܕܘܟܘܣ	204	Auteur		
Abel	ܗܒܝܠ		Saint		
Abgar V Roi d'Osroène (1 s.)			Saint		
Abḥai 	ܐܒܚܝ		Propriétaire précédent 		
Abḥaï de Nicée (5 s.)  	ܐܒܚܝ		Saint 		
Abimelek de Nisibe	ܐܒܝܡܠܟ	Needs ID	Auteur	the same as 793 ? Cf. Paris BnF syr. 024	
Abraham 	ܐܒܪܗܡ		annotateur		
Abraham (12-13 s.)	 Métropolite d'Edesse ܐܒܪܗܡ		Copié du temps de 		
Abraham (15 s.)	ܐܒܪܗܡ		Copiste 2 / lecteur		
Abraham (16 s.)	ܐܒܪܗܡ		Restaurateur		
Abraham bar Dodo (fin 15 s.)	ܐܒܪܗܡ		Copiste		
Abraham bar Giwargis de Ḥardin (16 s.)	ܐܒܪܗܡ		copiste		
Abraham bar 'Isa (13 s.)	ܐܒܪܗܡ		autre		
Abraham bar Manṣur bar Yawsep de Bet Buze (13 s.) 	ܐܒܪܗܡ ܒܪ ܡܢܨܘܪ ܒܪ ܝܘܣܦ		Commanditaire		
Abraham bar Sargis (15 s.)	ܐܒܪܗܡ		Copiste		
Abraham bar Šem'un bar Abraham bar Šem'un bar Israel d'Alqoš (19 s.-20 s.)	ܐܒܪܗܡ ܒܪ ܫܡܥܘܢ		Copiste		
Abraham bar Yawsep bar Ḥabib (15 s.)	ܐܒܪܗܡ		Copiste		
Abraham bar Yuḥanon (19 s.) 	ܐܒܪܗܐܡ ܒܪ ܝܘܚܢܢ 		Autre 		
Abraham bar Yuḥanon bar-Šeref (15-16 s.)	ܐܒܪܗܡ		Copiste		
Abraham d'Alexandrie (10 s.) 	ܐܒܪܐܗܐܡ		saint		
Abraham de Kaškar (6 s.)	ܐܒܪܗܡ		saint		
Abraham de Kobunis (9 s.) 	ܐܒܪܗܡ		copiste		
Abraham de la Haute Montagne (†406)	ܐܒܪܗܡ ܕܛܘܪܐ ܕܪܡ		Saint		
Abraham de Mar-Siméon-de-Qartmin (15 s.) 	ܐܒܪܗܡ		autre		
Abraham de Nisibe (6 s.)	ܐܒܪܗܡ	Needs ID	Auteur		
Abraham de Qidun (4 s.)	ܐܒܪܗܡ ܩܝܢܕܘܢܝܐ, ܐܒܪܗ ܟܐܘܪܗܝܐ	Needs ID	Auteur (Attribué à) / saint		
Abraham Ecchellensis (†1664)			Copiste		
Abraham et Maron (6 s.)	ܐܒܪܗܡ ܘܡܪܘܢ		Saint		
Abraham Zabaya	ܐܒܪܗܡ	Needs ID	Auteur		
Abraham, prophète	ܐܒܪܗܡ		Saint		
Abraham, proviseur du monastère des Moines sincères (8 s.)	ܐܒܪܗܡ		Copié du temps de		
Abu al-Faraj bar Abraham (12-13 s.)	ܐܒܘ ܐܠܦܪܓ ܒܪ ܐܒܪܗܡ		Copiste		
Abu al-Faraj ibn Ḥasan	ܐܒܘ ܐܠܦܪܓ		Propriétaire précédent		
Abu Naṣer bar Yawsep (13 s.)	ܐܒܘ ܢܨܪ		autre		
Abu Sa'id	 al-Dawlah ܐܒܘ ܣܥܝܕ		famille du copiste / autre		
Abualfadal bar Abualkaram d'Arbèles	ܐܒܘܐܠܦܕܠ		Propriétaire précédent		
Abu-l-Fataḥ d'Alep (11-12 s.) 	ܒܘܠܦܬܚ		Financé par		
Abulḥasen 	ܐܒܘܠܚܣܝܢ		Propriétaire précédent 		
Abu-Sa'adat de Mossul	ܐܒܘܣܥܕܐܬ		Propriétaire précédent		
Adam (17 s.)	ܐܕܡ		Copiste		
ADBS	Association des professionnels de l'information et de la documentation (France) / Secteur Audiovisuel		Propriétaire précédent		
Addaï bar Zumaya et Gura	ܐܕܝ		Propriétaire précédent		
Addaï de Gamba	Bet Qaṭo, ܐܕܝ		Propriétaire précédent		
Addaï Scher (1867-1915)	ܐܕܝܫܝܪ		Propriétaire précédent / Copiste		
Addaï, chorévêque			saint		
Adi bar Lazare (8 s.)	ܥܐܕܝ		Copiste		
Agnès, martyre de Rome (3 s.)	ܗܓܢܐ		Saint		
Aḥiqar	ܐܚܝܩܪ		Saint		
Aḥob Qaṭraya	ܐܚܘܒ ܩܛܪܝܐ	324	Auteur		
Alessandro Innamorati de Bartocci  			Fabricant du papier		
Alexis (5 s.)	 Homme de Dieu / (Nestor ܢܣܛܘܪܝܣ Riša)*  ܐܠܟܣܝܣ	607	Saint		
Alipiya (18 s.)	ܐܠܦܝܐ		Financé par		
Al-Kindi (†873)		Needs ID	Auteur		
Alṭun Alphonse Galo de Mossoul (fin 19 s.)	 Archidiacre de Mossoul, Patriarche des Chaldéens ܐܠܛܘܢ ܐܠܦܢܣܘܣ ܓܐܠܘ		Commanditaire		
Amat (18 s.)	ܐܡܬ		Financé par		
Ammon 	ܐܡܘܢ		Saint		
Ammonas (4 s.)	ܐܡܘܢܝܣAmmonios 	855	Auteur		
Amoun	ܐܡܘܢ		Saint		
Amphiloque d'Iconium (4 s.)  	ܐܡܦܝܠܟܝܘܣ	Needs ID	Attribué à		
Anba Sargi bar Sargis d'Édesse (9 s.)	ܐܢܒܐ ܣܪܓܝ		Copiste		
André Aḥijan (17 s.)	Patriarche	Needs ID	Auteur		
André et Barthélémy, apôtres (1 s.)	 ܒܪܬܘܠܡܐܘܣ  ܐܢܕܪܐܘܣ		Saint		
André et Matthieu, apôtres (1 s.)	ܐܢܕܪܐܘܣ   ܡܬܝ		Saint		
André, apôtre (1 s.)	ܐܢܕܪܐܘܣ		Saint		
Andronic et Athanasie d'Antioche	 ܐܬܐܢܣܝܐ  ܐܢܕܪܘܢܝܩܘܣ		Saint		
Anthime de Trébizonde (6 s.)	ܐܢܬܝܡܘܣ	Needs ID	auteur		
Antoine le Grand (†356)	ܐܢܛܘܢܝܘܣ	Needs ID	Auteur / saint		
Anṭonios Sionite (16-17 s.)	ܐܢܛܘܢܝܘܣ ܨܗܝܘܢܝܐ, Antoine		Copiste		
Anṭun	ܐܢܛܘܢ		Autre		
Apnimaran		883	Auteur 		
Apollo et Amoun 	 ܐܦܠܘ ܘܐܡܘܢ 		Saint		
Apollo le Petit 	ܐܦܠܘ ܙܥܘܪܐ		Saint		
Aqabšmo, Yawsep et Aytilho (†379) 	ܥܩܒܫܡܐ, ܝܘܣܦ, ܐܝܬܝܠܗܐ		Saint		
Archélidès de Constantinople	ܐܪܟܝܠܕܝܣ		Saint		
Aristote de Stagire (384-322 av. J.-C.)	ܐܪܝܣܛܘܛܐܠܝܣ, ܐܪܝܣܛܛܠܝܣ 	342	Auteur		
Arsène	ܐܪܣܢܝܣ		Saint		
Asia	ܐܣܝܐ		Saint		
Aškenuri de Bet Ḥesne (11-12 s.) 	moniale arménienne ܐܫܟܢܘܪܝ		Financé par		
Assemani, Giuseppe Simone (1687-1768)			Annotateur		
Aṭa Allah (16 s.)	ܥܛܐ ܐܠܗ		Illustrateur		
Atanasios	ܐܬܢܣܝܘܣ		Propriétaire précédent		
Atanasios (12-13 s.)	 Athanase Patriarche d'Antioche ; Métropolite d'Édesse  ܐܬܢܐܣܝܘܣ		Copié du temps de		
Aṭanasios (16 s.) 	Athanase, Métropolite de Ḥabib		Copié du temps de…		
Athanase d'Alexandrie († 373)	ܐܬܢܣܝܘܣ	354	Auteur		
Athanase de Balad (†686)	ܐܬܢܣܝܘܣ	109	auteur		
Athanase de Jérusalem (13-14 s.)	ܐܬܐܢܣܝܘܣ 	Needs ID	Auteur		
Athanase Safar de Mardin	اثانسيوس سفر	Needs ID	Auteur		
Athanase Seysel de Mardin (17 s.)			Copiste 2		
Awgin (4 s.)	Eugène ܐܘܓܝܢ  		Saint		
Awgusṭinos (19 s.)	Augustin Thomas,  ܐܘܓܘܣܛܝܢܘܣ		Copiste		
Awgusṭinos patriarche (19 s.)	Catholicos, patriarche de l'Orient, ܐܘܓܘܣܛܝܢܘܣ Augustin		Copié du temps de		
Awša'ia bar Isḥaq bar Tawma (fin 19 s.)	ܥܘܫܥܝܐ		Copiste		
Aziz d'Amid (18 s.)	Patriarche, ܥܙܝܙ		Propriétaire précédent		
Aziz de Barṭella (13 s.)	ܥܙܝܙ		copiste		
Babylas d'Antioche (†250) 	ܒܒܘܠܐ		Saint		
Bacchus bar Yuḥanon (16 s.)	ܒܟܘܣ		copiste		
Badimo l’Archimandrite (†375)	ܒܕܡܐ		Saint		
Balaï		27	Attribué à		
Bar 'Idta (†612)	ܒܪ ܥܕܬܐ		saint		
Barba'šemin (†346)	ܒܪܒܥܫܡܝܢ, Barbasymas		Saint		
Barbe et Julienne (3 s.?)	Barbara et Julienne  ܒܪܒܪܝܐ, ܝܘܠܝܢܐ		Sainte		
Barḥadbešabbo	ܒܪܚܕܒܫܒܐ		restaurateur		
Barḥadbšabba 'Arbaya (6-7 s.)	ܒܪܚܕܒܫܒܐܥܪܒܝܐ	367	Auteur		
Barsabias († c. 342)	ܒܪܒܣܒܝܣ		Saint		
Bar-Sa'id Sobo, dit Muqaddesi (12 s.)	ܒܪ ܣܥܝܕ, ܡܩܕܣܝ		copiste		
Barsam (18 s. ?)	ܒܪܣܡ		Annotateur		
Barṣawma 	ܒܪܨܘܡܐ, ܒܪܨܝܡ		Copiste / Propriétaire précédent		
Barṣawma (12-13 s.)	ܒܪܨܘܡܐ		Ayant participé à la confection du manuscrit		
Barṣawma bar Yuḥanon de Kfarze (19 s.)	 Barṣawma de Qartmin ܒܪܨܙܡܐ ܒܪ ܝܘܚܢܢ ܕܟܦܪܙܐ		Copiste / Propriétaire précédent		
Barsawma bar Yuḥanon de Midyat	ܒܪܨܘܡܐ		lecteur		
Barṣawma de Tamrza (19 s.)	ܒܪܨܘܡܐ ܕܬܡܪܙܐ		Commanditaire		
Barṣawma de Tella de Mar'aš (11 s.) 	ܒܪܨܘܡܐ		Restaurateur		
Barṣawmo (†458)	ܒܪܨܘܡܐ		Saint		
Barthélémy, apôtre (1 s.)	ܒܪܬܘܠܡܐܘܣ		Saint		
Basile (9 s.)	ܒܐܣܝܠܝ		copiste du modèle		
Basile de Césarée (†379)	ܒܣܝܠܣ ܩܣܪܝܐ	376	Auteur / Saint / Attribué à		
Basile Man'amaya	ܒܣܝܠܝܘܣ ܡܢܥܡܝܐ	Needs ID	Auteur		
Basilios (♱1445)	 (Maphrien du Ṭur 'Abdin)* ܒܣܝܠܝܘܣ	Needs ID	Auteur / Copié du temps de		
Basilios (moitié 19 s.)	Maphrian de l'Orient, ܒܣܝܠܠܝܘܣ , Behnam de Mossoul , ܒܗܢܐܡ		Copié du temps de		
Basilios 'Aziz (15 s.)	Catholicos d'Orient  ܒܣܝܠܠܝܘܣ ܥܲܙܝܙ		Copié du temps de		
Basilios Išo' (17 s.)	 Maphrien  ܒܣܝܠܠܝܘܣ ܝܫܘܥ		Copié du temps de		
Basilios Šem'un (17 s.)			Copié du temps de		
Basiolios de Zargel (16 s.)	Išo' Zazoyo, ܒܣܝܠܠܝܘܣ, Basile, ܙܪܓܠ		Autre		
Bassus (16 s.)	ܒܣܘܣ		autre		
Bassus et Suzanne (4 s.)	 ܒܣܘܣ ܘܫܘܫܢ		Saint		
Batista (16 s.)	ܒܐܬܝܣܬܐ		Commanditaire		
Baumstark, Anton (von)			Propriétaire précédent 		
Ba'ut (15 s.)	ܒܥܘܬ		Propriétaire précédent		
Behnam	ܒܗܢܡ		Propriétaire précédent 		
Behnam (17 s.)	ܒܗܢܡ, Patriarche		commanditaire		
Behnam (4 s.?)	ܒܗܢܡ		Saint		
Behnam (fin 19 s.)  	ܒܗܢܐܡ		autre		
Behnam bar Ḥanu Ya'qub Šamsuko et Barbara sœur d'Ibrahim (fin 19 s.)	ܒܗܢܐܡ		famille du copiste		
Bellarmin, Robert (1542-1621)	ܪܘܒܪܛܘܣ ܒܠܠܪܡܝܢܘ	Needs ID	Auteur		
Benoît XIV (†1758)			Copié du temps de…		
Bet Abuna	ܒܝܬ ܐܒܘܢܐ		Famille du copiste		
Bet al-Gani	ܒܝܬ ܐܠܓܢܝ		Famille du copiste		
Bet Asmar	ܒܝܬ ܐܣܡܪ		Famille du copiste		
Bet Barbat	ܒܝܬ ܒܪܒܬ		Famille		
Bet Dabeš de Telkef	ܒܝܬ ܕܒܝܫ		famille du copiste		
Bet Pelet	ܒܝܬ ܦܠܬ		Famille		
Bet Qaṭo	ܒܝܬ ܩܲܛܘܿ		Famille		
Bet Šekwana	ܒܝܬ ܫܟܘܢܐ		Famille du copiste		
Bet Tawma	ܒܝܬ ܬܐܘܡܐ		famille du copiste		
Bet Zreiq	ܒܝܬ ܙܪܝܩ		Famille		
Bidros (19 s.)	Pierre ?		Propriétaire précédent		
Bišara ibn Abdul-'Aziz de Nabakh			Propriétaire précédent		
Bišoy (†417)	ܒܝܫܘܝ		Saint 		
Bišoy de Constantinople	ܒܝܫܘܝ	Needs ID	Auteur		
Brière Maurice (1881-1960)			Propriétaire précédent		
Carvajal, Bernardin-Loup (16 s.)			Commanditaire		
Célestin de Rome (†432)	ܩܐܠܐܣܛܝܢܘܣ	Needs ID	auteur		
Chabot, Jean-Baptiste (1860-1948)	ܫܒܘ 		Propriétaire précédent		
Chénouté d'Atripé (†466)	Šanudin  ܫܢܘܕܝܢ		Saint		
Christophore d'Antioche (†249)	 ܟܪܝܣܛܘܦܘܪܘܣ 		Saint		
Claude Hardy (17 s.)			Propriétaire précédent		
Claude Ptolémée (2 s.)	ܦܛܐܠܘܡܘܣ	Needs ID	Auteur		
Clément de Rome († c. 101) 	ܩܠܡܝܣ	Needs ID	Attribué à / Saint		
Clément VIII Pape (†1605)	ܟܠܡܢܬܣ, ܟܠܐܡܢܬܣ ܐܘܛܝܒܝܘ		Copié du temps de…		
Coislin, Henri-Charles de (1665-1732)			Propriétaire précédent		
Côme et Damien 	ܩܘܙܡܐ ܘܕܘܡܝܢܐ		Saint		
Constantin de Laodicée (7 s.)	ܩܘܢܣܛܢܛܝܢܐ	Needs ID	auteur		
Constantin, empereur (†337) 	ܩܘܣܛܢܛܝܢܘܣ		Saint 		
Cosmas le diacre (5-6 s.)	ܩܘܙܡܐDisciple de Siméon le Stylite 	31	Auteur		
Cyprien et Justine (3 s.) 	ܩܘܦܪܝܢܐ, ܝܘܣܛܐ 		Saint		
Cyprius et Patermuthius   	ܦܛܪܦܡܘܛܝܣ ܩܘܦܪܝܣ		Saint		
Cyriaque de Behnasa 	 Cyriaque d'Oxyrhynque  ܩܘܪܝܐܩܘܣ	Needs ID	Auteur		
Cyriaque de Mardin († 623) 	ܩܘܪܝܩܐ	Needs ID	Auteur		
Cyriaque et Juliette (début 4 s.)	 Cyrique et Julitta ܩܘܪܝܩܘܣ ܘܝܘܠܝܛܐ		Saint		
Cyrille d'Alexandrie (†444)	ܩܘܪܝܠܘܣ	430	auteur		
Cyrille de Jérusalem (†387)	ܩܘܪܝܠܘܣ	431	Auteur		
Dadišo' Qaṭraya (7 s.)	ܕܕܝܫܘܥ ܩܛܪܝܐ	434	Auteur		
Damase de Rome (†384)	ܕܡܣܘܣ	841	auteur		
Daniel (12-13 s.)	ܕܢܝܠ		Ayant participé à la confection du manuscrit		
Daniel bar Sim'an bar 'Iso (19 s.)	ܕܢܝܐܝܠ ܒܪ ܣܡܥܐܢ ܒܪ ܥܝܣܐ		Copiste 		
Daniel de Galaš	ܕܢܝܐܠ ܕܓܠܫ		Saint		
Daniel de Mardin	ܕܐܢܝܐܠ ܐܒܢ ܥܝܣܝ	256	Auteur		
Daniel de Ṣalaḥ (6 s.)	ܕܢܐܝܠ ܕܨܠܚ	59	Auteur		
Daniel de Scété (6 s.)	ܕܢܝܐܝܠ	Needs ID	Attribué à		
Daniel et Warda († c. 341)	ܕܢܝܐܝܠ, ܘܪܕܐ		Saint		
Daniel le Médecin	ܕܢܝܐܝܠܕ ܐܣܝܐ		Saint		
Dasi	ܕܐܣܝ		Saint		
David fils de Paul	ܕܘܝܕ, ܕܰܘܻܝܕ ܒܰܪ ܦܰܘܠܳܘܣ	144	Auteur		
David le phénicien	ܕܘܝܕ	273	Auteur		
Dawid 	ܕܘܝܕ, David		Copiste		
Dawid (12-13 s.)	ܕܘܝܕ David		Ayant participé à la confection du manuscrit		
Dawid (avant 1292 AD)	David  ܕܘܘܝܕ		Copiste		
Dawid (fin 15 s.)	ܕܘܝܕDavid 		Copiste		
Dawid bar Gusu (15 s.)	ܕܘܝܕ ܒܪ ܓܘܣܘDavid 		Propriétaire précédent		
Dawid bar Hormizd bar Kanun (19 s.)	ܕܘܝܕ, David		Copiste 		
Dawid bar Mikail (11 s.)	David, ܕܘܝܕ		commanditaire		
Dawid bar Mubarak de Mardin (16 s.) 	ܕܘܝܕ, David		Propriétaire précédent]		
Dawid d-Gabrun (13 s.)	ܕܘܝܕ   ܕܓܒܪܘܢ  David		Copiste 		
Dawid, du monastère des Syriens (16 s.)	David, ܕܘܝܕ		autre		
Dawud (11 s.)	ܕܘܘܕDavid 		Traducteur		
Dawud al-Anṭaki	ܕܘܘܕ ܐܠܐܢܛܟܝ	Needs ID	Auteur		
Dawud bar Ḥanu Ya'qub Šamsuko et Barbara sœur d'Ibrahim (fin 19 s.) 	ܕܘܘܕ ܒܪ ܚܢܘ ܝܥܩܘܒ ܫܡܣܘܟܐ ܘܒܪܒܪܐ ܚܬܗ ܕܐܒܪܗܝܡ		Copiste		
Dawud ibn Elias (19 s.)	ܕܐܘܕ ܒܢ ܐܠܝܐܣ		Commanditaire		
Dawud ibn QŠ'FW (15 s.)	دود يبن قشافو, David		Propriétaire précédent		
De Migieu (18 s.)			Propriétaire précédent		
de Noailles, Louis Antoine (17-18 s.)	Archevêque de Paris		commanditaire		
Delaporte, Louis-Joseph (1874-1944)			Propriétaire précédent		
Denḥa (15 s.)	ܕܢܚܐ		Commanditaire		
Denḥa (9 s.)	ܕܢܚܐ	177	Attribué à		
Denys bar Ṣalibi (†1171)	ܕܝܢܘܣܝܘܣ ܒܪ ܨܠܝܒܝ,  Dionysisos bar Salibi 	212	Auteur		
Denys l'Aréopagite (1 s.)	ܕܝܘܢܘܣܝܣ		Saint		
Deslandes (18 s.)	abbé		Copiste 2		
Dionysios (15 s.)	Métropolite de Ma'dan / Denys ܕܝܘܢܢܘܣܝܘܣ		Commanditaire		
Dionysios (19 s.)	Métropolite Behnam de Mossoul, ܕܝܘܢܝܣܝܘܣ, ܒܗܢܐܡ		Copié du temps de		
Dionysios de Qartmin (12-13 s.)	ܕܝܘܢܣܝܘܣ		Copié du temps de...		
Dionysios Yawnan (18 s.)	 Métropolite ܕܝܢܢܣܝܘܣ ܝܘܢܢ		Copié du temps de…		
Dioscore d’Alexandrie (†452)	ܕܝܘܣܩܘܪܘ		Saint		
Dioscore de Gazarta	ܕܝܘܣܩܘܪܘܣ	243	auteur		
Dioscore le prêtre 	ܕܝܘܣܩܘܪܐ		Saint		
Dioscoros (15 s.)	Dioscore, Métropolite de Jérusalem, ܕܝܘܣܩܘܪܘܣ		commanditaire		
Dioscoros de Kafro (15 s.)	ܕܝܘܣܩܘܪܘܣ, Dioscore		Copié du temps de…		
Domèce le Médecin	ܕܝܡܛ		Saint		
Duval, Rubens (1839-1911)			Annotateur		
Ehlhardt, George Brinkmann (20 s.)			Propriétaire précédent		
Eliano, Giovanni Battista (1530-1589)			Lecteur		
Élie de Nisibe (†1046)	ܐܠܝܐ, ܐܠܻܝܴܐ ܡܰܛܪܳܘܦܳܘܠܝܻܛܳܘܤ ܕܨܵܘܒܲܐ Élie de Ṣoba	472	Auteur		
Élie I (†1049)	Catholicos ܐܠܝܐ 	468	Attribué à		
Élisée, disciple de Malchus de Clysma (4-5 s.)	ܐܠܝܫܥdisciple de Malchus de Clysma	Needs ID	Attribué à		
Eliya (†1722)	 (Elie XI Patriarche catholique nestorien d'Orient)* ܐܠܝܐܩܬܘܠܝܩܐܦܛܪܝܪܟܐܕܡܕܢܚܐ		Copié du temps de		
Eliya (†1750)	Élie XII, ܐܠܝܐ, Patriarche catholique d'Orient		Copié du temps de…		
Eliya (16 s.)	(Elie III Catholicos)*  ܐܠܝܐ		Saint		
Eliya (17 s.)	Élie ܐܠܝܐ		Propriétaire		
Eliya (18-19 s.)	Métropolite d'Arbèles, ܐܠܝܐ, اليا		Copiste		
Eliya (19 s.)	 XII patriarche chaldéen de Mossou ܐܠܝܐ Élie, Patriache catholique d'Orient		Copié du temps de…/ Commenditaire		
Eliya (8 s.) 	ܐܠܝܐ, Patriarche d'Antioche 		Copié du temps de 		
Eliya (9-10 s.)	ܐܠܝܐ, Élie		Copiste		
Eliya bar Abraham (16 s.)	 Élie ܐܠܝܐ 		Copiste		
Eliya bar Homo bar Eša'ya bar Homo bar Ḥana bar Homo bar Daniel bar Eliya bar Daniel, dits de Bet Naṣrod'Alqoš (19-20 s.)	ܐܠܝܐ ܒܪ ܗܘܡܘ ܒܪ ܐܫܥܝܐ ܒܪ ܗܘܡܘ ܒܪ ܕܢܝܐܝܠܒܪ ܐܠܝܐ ܒܪ ܕܢܝܐܝܠ  ܕܡܬܕܠܠܝܢ ܕܒܝܬ ܢܨܪܘ ܐܠܩܘܫܝܐ		Copiste		
Eliya bar Šem'un bar Quriaqos (19 s.) 	ܐܠܝܐ ܒܪ ܫܡܥܘܢ ܒܪ ܩܘܪܝܩܘܣ		copiste		
Eliya de Bagdad (17 s.)	ܐܠܝܐ, Élie		Propriétaire du modèle de ce manuscrit		
Eliya X (†1700)	 ܐܠܝܐ, Catholicos patriarche d'Orient , Élie		Copié du temps de...		
Eliyas 	ܐܠܝܐܣ		annotateur		
Eliyas (fin 19 s.)   	ܐܠܝܐܣ		Autre		
Eliyas al-Imrikios ibn Jirjis (19 s.)	اليا		Propriétaire précédent		
Eliyas bar Babaka bar Yawsep appelé Abarhina, de Šaqlawa (19-20 s.)	ܐܠܝܐܣ ܒܪ ܒܒܟܐ ܒܪ ܝܘܣܦ ܕܡܬܕܠܠ ܐܒܪܗܝܢܐ		Copiste, copiste 2		
Eliyas bar Guna bar Eša’ya bar Homo bar Ḥana bar Homo bar Daniel (19 s.)	ܐܠܝܣ ܒܪ ܓܘܢܐ ܒܪ ܫܥܝܐ ܘܒܪ ܗܘܡܘ ܘܒܪ ܚܢܐ ܒܪ ܗܘܡܘ ܘܒܪ ܕܢܝܐܝܠ		Copiste		
Eliyas ibn Jirjis (début 19 s.)			Propriétaire précédent		
Emmanuel (19-20 s.)	ܥܡܢܘܐܝܠ Patriarche de Babylone  		Copié du temps de		
Emmanuel bar Dawid bar Aaron bar Barṣawmu (16 s.)	ܥܡܢܘܐܝܠ ܒܪ ܕܘܝܕ ܒܪ ܐܗܪܘܢ ܒܪ ܒܪܨܘܡܘ		Copiste		
Emmanuel du Ṭur 'Abdin (13 s.)	ܥܡܢܘܐܝܠ		Propriétaire précédent		
Emmanuel Théodose de La Tour d'Auvergne, cardinal de Bouillon (1643-1715)	ܒܘܠܝܘܢ		Destinataire d'un texte		
Enanišo' (7 s.)	ܐܢܐܢܝܫܘܥ	474	Auteur		
Éphrem (19 s.)	ܐܦܪܝܡ		Propriétaire précédent		
Éphrem de Mar-Giwargis (19 s.)	ܐܦܪܝܡ		Copiste du modèle		
Éphrem de Mar-Ḥananya (19 s.)	ܐܦܪܝܡ		Propriétaire précédent		
Éphrem II Rahmani (1849-1929 s.) 	ܐܦܪܝܡ		Propriétaire du modèle de ce manuscrit		
Éphrem le Syrien (†373) 	ܐܦܪܝܡ, ܐܦܪَܐܡ Éphrem de Nisibe 	13	Auteur / Attribué à / Saint		
Épimanus de Rome			Saint		
Épiphane de Salamine	ܐܦܝܦܐܢܝܘܣÉpiphane de Chypre    	477	Auteur		
Eramya (fin 19 s.)	ܐܪܡܝܐ		Commanditaire		
Eramya bar Tawma (18 s.) 	ܐܪܡܝܐ ܒܪ ܬܘܡܐ		Copiste 		
Eramya de Mar-Barṣawma (11-12 s.)	ܐܪܡܝܐ, Jérémie		Financé par		
Ésope	 Josippon ܝܘܣܝܦܘܣ	322	Auteur 		
Étienne (14 s.)	ܐܣܛܦܢܘܣ, ܣܛܦܢ		Copiste		
Étienne de Batroun (18 s.)	ܐܣܛܦܢܘܣ 		Copiste		
Étienne Douaihi (1630-1704) 	Patriarche maronite d'Antioche 	460	Auteur		
Étienne, disciple d'Abraham de la Haute Montagne (5 s.)	ܐܣܛܦܢܘܣ	Needs ID	Auteur		
Étienne, martyr (1 s.)	ܣܛܦܢܘܣ		Saint		
Eudochos de Mélitène (12 s.)	ܐܸܒܕܵܘܟܵܣ	Needs ID	Auteur		
Eudoxius (1-2 s.) 			Saint		
Eugène l'égyptien	ܐܘܓܢܝܣ ܡܨܪܝܐ		Saint		
Eugénie, martyre de Rome (fin 2 s.)	ܐܘܓܢܝܐ		Saint		
Euloge le Carrier (6 s.)			saint		
Euloge, ascète (4 s.) 	ܐܘܠܘܓ		saint		
Eumusa (9-10 s.)	ܐܘܡܣܐ		Destinataire		
Euphémie (3-4 s.)	ܐܘܦܝܡܝܐ		Sainte		
Euphrosyne d'Alexandrie	ܐܘܦܪܣܢܝ		Sainte		
Eupraxie (fin 4 s.)	Antigone et Eupraxie ܐܘܦܪܐܟܣܝܐ		Sainte		
Eusèbe de Césarée (ca.†340)	ܐܘܣܝܒܘܣܩܣܪܝܐ, ܐܣܒܝܣ	480	Attribué à		
Eusèbe de Samosate (†380)	ܐܘܣܒܝܘܣ		Saint		
Eustathe d'Antioche († vers 337)	ܐܘܣܛܐܬܝܘܣ	Needs ID	auteur		
Eustathe-Placide (2 s.)	ܦܠܩܝܕܐ   ܐܘܣܛܐܬܐܘܣ 		Saint		
Euthalius 			Saint		
Évagre le Pontique (†399)	ܐܘܓܪܝܣ	483	Auteur / saint		
Ézéchiel 	ܚܙܩܝܐܝܠ		Saint		
Faraj (17 s.)	ܦܪܓ		Copiste 		
Faraj de Mar-Garbuna (13 s.)	ܦܪܓ		Copiste		
Fauste de Cyzique	ܦܘܣܛܐ ܕܡܢܩܘܙܝܩܘܣ		Sainte		
Fébronie (†304)	ܦܒܪܘܢܝܐ		Sainte		
Ferdinand, empereur d'Autriche (16 s.) 			dédicateur		
Fils de Duma (8 s. ?)	ܕܘܡܐ		Propriétaire précédent		
Foddhail bar Tawma (16 s.)			autre		
Francis bar Šamu bar Pagu de Telkef (19 s.)			Copiste		
Francis ibn Domenico de Ḥamat (16 s.)			lecteur		
Gabriel (8 s.)	ܓܒܪܐܝܠ 		Copiste		
Gabriel (9 s.)	ܓܒܪܐܝܠ		ayant participé à la confection du manuscrit		
Gabriel (15-16 s.)	ܓܒܪܐܝܠ, Evêque		Copié du temps de…		
Gabriel bar Ḥadbešabba bar Yawsep d'Alqoš (19 s.)	ܓܒܪܝܠ ܒܪ ܩܫܝܫܐ ܚܕܒܫܒܐ ܒܪ ܝܘܣܦ ܐܠܩܘܫܝܐ		Copiste du modèle		
Gabriel bar Išo' Sbirinoyo (15 s.)	ܓܒܪܐܝܠ ܒܪ ܝܫܘܥ ܣܒܝܪܝܢܝܐ		Copiste		
Gabriel bar Yawsep de 'WDRNS (12 s.)	ܓܒܪܐܝܠ		Propriétaire précédent		
Gabriel de Bet Rabban (17 s.)	ܓܒܪܐܝܠ ܕܒܝܬ ܪܒܢ	105	Auteur/ Relieur		
Gabriel de Gezira 	ܓܒܪܐܝܠ		Copiste		
Gabriel de Mar-Aḥḥa (16-17 s.)	ܓܒܪܐܝܠ ܕܡܪ ܐܚܐ	Needs ID	Auteur / copiste	cf. Paris BnF syr. 371, F	
Gabriel de Qartmin (†648)	Gabriel de Bet Qustān  ܓܒܪܐܝܠ ܕܩܪܬܡܝܢ		Saint		
Gabriel de Šiarzur (7 s.)	ܓܒܪܝܠ ܡܢ ܐܬܪ̈ܐ ܕܫܝܪܙܘܪ	Needs ID	Auteur		
Gabriel ibn al-Qala'i (15 s.)	ܓܒܪܐܝܠ ܐܒܢ ܐܠܩܠܐܥܝ		traducteur		
Galien  	ܓܠܝܢܘܣ	496	Attribué à		
Galw d'Arṭun (19 s.)	ܓܠܘ		Copiste		
Gan Batista (16 s.)	ܓܐܢ ܒܐܬܝܣܬܐ, Jean Baptiste, Gian Battista		Commanditaire		
Gendo bar Yawsep (15 s.)	ܓܢܕܐ ܒܪ ܝܘܣܦ		Lecteur		
Georges 	ܓܝܘܪܓܝܣ		Saint		
Georges de Nisibe	ܓܝܘܪܓܝܣ	Needs ID	Auteur		
Georges des Arabes (†724)	ܓܘܪܓܝ	122	Auteur		
Georges Warda (13 s.)	 ܓܝܘܪܓܝܣ ܘܪܕܐGiwargis Warda	504	Auteur		
Gérasime, solitaire			saint		
Gibrail Rabbat			Propriétaire précédent		
Gignoux, Philippe (1931- )			Propriétaire précédent		
Girgis bar Rafu Al'w' de Mossoul	ܓܪܓܝܣ ܒܪ ܪܦܘ̄ ܠܥܘܥ ܕܡܢ ܡܘܨܠ		Commanditaire		
Giwargis (16 s.) 	Georges, ܓܝܘܪܓܝܣ		Propriétaire précédent		
Giwargis (19 s.)	 ܓܝܘܪܓܝܣ 		Copiste		
Giwargis (fin 17 s.)	ܓܝܘܪܓܝܣ		Copiste du modèle		
Giwargis bar 'Abd al-Aḥad (fin 19 s.)	ܓܝܘܪܓܝܣ		Copiste		
Giwargis bar Bacchus de Bet Zreiq (16 s.)			Commanditaire		
Giwargis bar Hana de Bet Barbat de Telkef (19 s.) 	ܓܝܘܪܓܝܣ ܒܪ ܚܢܐ ܡܢ ܕܒܝܬ ܒܪܒܬ		Propriétaire précédent		
Giwargis bar Isepw	ܓܘܪܓܣ ܒܪ ܐܝܣܦܘ		Lecteur		
Giwargis bar Šem'un (12-13 s.)	ܓܝܘܪܓܝܣ Georges  		Ayant participé à la confection du ms		
Giwargis bar Ya'qub (19 s.)	ܓܝܼܘܲܪܓܝܼ݅ܣ ܒܪ ܝܥܩܘܒܼ		Copiste		
Giwargis de ḤDŠYT (15 s.)	Georges, ܓܝܘܪܓܝܣ		copiste		
Giwargis de ŠNQLBD (15 s.)	ܓܝܘܪܓܝܣ		Copiste du modèle		
Giwargis du monastère des Syriens (16 s.)	Georges, ܓܝܘܪܓܝܣ		autre		
Giwargis Galyana de Ṭaqyan (19-20 s.)	ܓܝܘܪܓܝܣ ܓܠܝܢܐ		Copiste		
Giwargis I (†680/1)	ܓܘܪܓܝܣ  Georges I Catholicos 	501	Auteur		
Giwargis Nerbaya (15-16 s.) 	ܓܝܘܪܓܝܣ ܢܐܪܒܝܐ    Georges de Nerba      		Restaurateur		
Giwargis Peṭros (17 s.)	Patriarche maronite d'Antioche, ܓܘܪܓܝܣ ܦܛܪܘܣ	Needs ID	Auteur		
Gordios	ܓܪܕܝܘܣ		Saint		
Goussens, H. 			Propriétaire précédent		
Graffin François (20 s.)			Propriétaire précédent		
Grégoire Barhebraeus (13 s.)	ܓܪܝܓܘܪܝܘܣ	239	Auteur		
Grégoire d'Arménie († c. 330)	ܓܪܝܓܘܪܝܘܣ		Saint		
Grégoire de Nazianze (†390)	ܓܪܝܓܘܪ ܝܘܣܕܢܙܝܢܙܘ	511	Auteur / saint		
Grégoire de Nysse (4 s.)	ܓܪܝܓܪܝܘܣ	512	Auteur		
Grégoire Jacques (†1214)	ܓܪܝܓܪܝܘܣ, Maphrien, neveu de Michel le Syrien	222	auteur		
Grégoire le moine (7 s.) 	Grégoire de Chypre, ܓܪܝܓܪܝܘܣ	21	Auteur		
Grégoire le prêtre	ܓܪܝܓܘܪܝܘܣ, Grégoire de Césarée	Needs ID	auteur		
Grégoire le Thaumaturge († c. 270)			Saint		
Grigor de Gamre	Grégoire  ܓܪܝܓܘܪ ܓܡܪܝܐ	Needs ID	Auteur		
Grigorios (16 s.)	Métropolite de Jérusalem, Grégoire, ܓܪܝܓܘܪܝܣ		Copié du temps de… / Annotateur		
Grigorios (17 s.) 	Évêque de Jérusalem, Yuḥanna de Damas, Grégoire, ܓܪܝܓܪܝܘܣ  Behnam ܝܘܚܢܐ		copiste		
Grigorios (fin 12 s.)	 Métropolite de Tagrit et de Mossoul  ܓܪܝܓ[ܘ]ܪܣ		Copié du temps de..		
Grigorios de Rumanah (12-13 s.)	ܓܪܝܓܘܪܝܘܣ, Grégoire		Financé par		
Grigorios Eliyas (18 s.) 	Métropolite de Jérusalem ܓܪܝܓܘܪܝܣ ܐܠܝܐܣ		Copié du temps de..		
Guillois (19 s.)	Gérant du consulat de France à Mossoul		Propriétaire précédent		
Gurya (9 s.)	ܓܘܪܝܐ		ayant participé à la confection du manuscrit		
Gurya et Šmona (3-4 s.)	ܓܘܪܝܐ  ܫܡܘܢܐ		Saint		
Ḥabib (†322)	ܚܒܝܒ		Saint		
Ḥabib (15-20 ?)	ܚܒܝܒ		Copiste supposé		
Ḥabib de Mar-Barṣawma (11-12 s.)	ܚܒܝܒ		Financé par		
Halhce (?), John Rob(er)t			Propriétaire précédent		
Ḥana Marwgy (apr. 17 s.)	ܚܢܐ ܡܪܘܓܐ		Propriétaire précédent		
Ḥananya bar Yuḥanon de Mardin (12 s.) 	 Ananias ܚܢܢܝܐ		Commanditaire		
Ḥaneh de Bet Seto	ܚܢܗ 	Needs ID	Auteur		
Ḥannina (†490)	ܚܢܢܝܐ		Saint		
Ḥanun	ܚܐܢܘܢ	Needs ID	Auteur	Cf. Paris BnF syr. 403	
Harlay de Champvallon, François († 1695)			Copié du temps de		
Ḥassan bar Bahlul (10 s.)	ܚܣܢ ܒܪ ܒܗܠܘܠ	365	Auteur		
Helena (18 s.)	ܗܠܢܐ		Financé par		
Hélène, mère de Constantin (4 s.) 	ܗܠܢܝ		Saint		
Héliodore, Dosas, Mareabes et ‘Abdišo’ (†361-362)			Saint		
Helladius de Césarée		Needs ID	Attribué à		
Henri II de Guise (1614-1664) 	ܗܢܪܝܟܘ ܕܟܘܝܙܐ		Destinataire d'un texte		
Henriette de Chavigny († 1664)	Comtesse de Brienne, ܟܢܬܣܐ ܕܒܪܝܢ		Destinataire d'un texte		
Hilal bar Giwargis			Propriétaire précédent		
Hilaria, ermite égyptienne (5 s.)	ܐܠܐܪܝܐ		Saint		
Hindi (18 s.) 	ܗܢܕܝ		Copiste		
Ḥnanišo'	ܚܢܢܝܫܘܥ	Needs ID	Auteur		
Ḥnanišo (16 s.)	ܚܢܢܝܫܐ		Copiste		
Homo bar Daniel bar Eliya (18 s.)	ܗܘܡܘ ܒܪ ܕܢܝܐܝܠ ܒܪ ܐܠܝܐ		Copiste du modèle		
Honorius, empereur (†423)	ܐܢܘܪܝܘܣ		Saint		
Hormizd (14-15 s.)	ܗܘܪܡܙܕ		Propriétaire précédent		
Hormizd bar Beriku (18 s.)	ܗܘܪܡܙܕܒܪܒܪܝܟܘ		Copié du temps de		
Hormizd de Bet Lapaṭ (7 s.)	ܗܘܪܡܝܙܕ ܕܒܝܬ ܠܦܛ		Saint		
Ḥunayn ibn Isḥaq (9 s.)	 ܚܘܢܝܢ ܐܒܢ ܐܝܣܚܩ  	542	Auteur		
Ibn al-'Assal († ca. 1265)	ܐܒܢ ܐܠܥܣّܐܠ	Needs ID	Auteur	cf. Charfet Rahmani 013	
Ibrahim (fin 19 s.) 	ܐܒܪܐܗܝܡ		Autre		
Ibrahim al-Kebaz de Jérusalem (16 s.)	ܐܒܪܐܗܝܡ		autre		
Ibrahim ibn Mas'ud (19 s.)	ܐܒܪܗܡ ܒܢ ܡܣܥܘܕ		Annotateur		
Ibrahim le Syrien	ابراهيم		lecteur		
Iešu' ibn 'Abd al-Aḥad, neveu Yuḥanna ibn Maqdisi Šem'un al-'Abaji (18 s.) 	يشوع ابن عبد الاحد ابن اخو قسيس يوحنا اولاد مقدسي شمعون العباجي		Propriétaire précédent		
Ignace d'Antioche (†107)	ܐܓܢܛܝܘܣ		Saint		
Ignaṭios (13 s.)	ܐܝܓܢܐܛܝܘܣ, Ignace, Patriarche d'Antioche et de Syrie		Copié du temps de…		
Ignaṭios (14 s.)	Patriarche d'Antioche et de Syrie, ܐܝܓܢܐܛܝܘܣ,, Ignace		Copié du temps de…		
Ignaṭios (15 s.)	ܐܝܓܢܐܛܝܼܘܣ		Commanditaire		
Ignaṭios (16 s.)	ܐܝܓܢܐܛܝܘܣ , Patriarche de Syrie, Ignace, , ܦܝܠܠܛܘܣ, Pileṭos		Copié du temps de		
Ignaṭios (16 s.)	Išo' Zazoyo, ܐܝܓܢܐܛܝܘܣ		Autre		
Ignaṭios (17 s.)	 Ignace (Patriarche d'Antioche)*  ܐܝܓܢܐܛܝܘܣ		Copié du temps de		
Ignaṭios 'Abd al-Masiḥ (1662-1686) 	Ignace, ܐܝܓܢܐܛܝܘܣ, Patriarche d'Antioche et de Syrie, ܥܒܕܐܠܡܣܝܚ		Copié du temps de		
Ignaṭios 'Aziz bar Sabta (15 s.)	Patriarche du Ṭur 'Abdin  ܐܝܓܢܛܝܘܣ ܥܙܝܙ ܒܪ ܣܒܬ 		Copié du temps de..		
Ignaṭios bar Qiqi	ܐܝܓܢܐܛܝܘܣ ܒܪ ܩܝܩܝ	189	Auteur		
Ignaṭios bar Wahib (†1333)	ܐܝܓܢܐܛܝܘܣ	249	auteur		
Ignaṭios de Jerusalem (12 s.)	ܐܝܓܢܛܝܘܣ, Ignace 		commanditaire de restauration		
Ignaṭios de Mar-Mattaï	ܐܝܓܢܐܛܝܘܣ	Needs ID	Auteur		
Ignaṭios II (12 s.)	Métropolite de Jérusalem, ܐܝܓܢܐܛܝܘܣ, Ignace		Commanditaire		
Ignaṭios Jacques (1847-1871)	Ignace Patriarche d'Antioche,    ܐܝܓܢܐܛܝܘܣ, ܝܥܩܘܒ		Copié du temps de		
Ignaṭios Jean XIII Bar Sila (†1493)	Ignace Patriarche d'Antioche, ܐܝܓܢܐܛܝܘܣ 	Needs ID	Auteur		
Ignaṭios Kaleph (15 s.)	ܐܝܓܢܛܝܘܣ ܟܠܦ   (Patriarche de Mardin)* 		Copié du temps de		
Ignaṭios Mas'ud (fin 15 s.)	ܐܝܓܢܛܝܘ  (Patriarche du Ṭur 'Abdin)* 		Copié du temps de..		
Ignaṭios Mattyos (18 s.) 	ܐܝܓܢܐܛܝܘܣ ܡܬܝܘܣ, Patriarche d'Antioche		Copié du temps de..		
Ignaṭios Ni'mat Allah (†1587)	Patriarche d'Antioche, Ignace		Propriétaire précédent		
Ignaṭios Pierre  (1872-1894)	Ignace Patriarche d'Antioche, Pierre III de Mossul,   ܐܝܓܢܐܛܝܘܣ, ܒܛܪܘܣ		Copié de temps de		
Ignaṭios Šem'un (17 s.)	 Patriarche   Ignace   ܐܝܓܢܐܛܝܣ ܫܡܥܘܢ		Copié du temps de		
Ilya (17 s.)	ܐܝܠܝܐ		Lecteur		
Ilyas Mirjan (18 s.)	الياس ميرجان		Propriétaire précédent		
Imad (fin 17 s.)	ܥܡܐܕ		Lecteur		
Isa bar 'Eša'ya bar Quryaqos, du village d'Aqror (19 s.)	ܐܝܣܐ		Copiste 		
Isa bar Išo' bar Ḥasan de Hatba (14 s.)	ܥܝܣܐ		copiste du modèle		
Isaac d'Alqoš	ܐܝܣܚܩ ܐܠܩܘܫܝܐ	Needs ID	Auteur		
Isaac d'Antioche (5 s.)	ܐܝܣܚܩ	33	Auteur		
Isaac de Ninive (7 s.)	 Isaac le Syrien ܐܝܣܚܩܕܢܘܢܘܐ	550	Auteur		
Isaïe d'Alep	ܐܫܥܝܐܡܢܚܠܒ		Saint		
Isaïe de Scété 		548	Auteur		
Isḥaq (fin 19 s.)	ܐܣܚܐܩ		Autre		
Isḥaq bar Abraham de Bet Deyoqo	ܐܝܣܚܩ Isaac		Propriétaire précédent		
Isḥaq bar Maria de Tel (17 s.) 	ܝܣܚܩ ܒܪ ܡܪܝܐ, Isaac		Copiste		
Isḥaq de Bet Alpe (13 s.)	Isaac  ܐܝܣܚܩܕܒܝܬܐܠܦ̈ܐ 		Restaurateur		
Isḥaq de Ḥaṣrun (16 s.)	Isaac, ܐܝܣܚܩ		Autre		
Isḥaq de Mossoul	Isaac, ܐܣܚܩ		traducteur		
Isḥaq de Rome (17 s.)	Isaac, ܝܣܚܩ		Copiste 2		
Išo' (12 s.)	ܝܫܘܥ		Autre		
Išo' (13 s.)	ܝܫܘܥ		Propriétaire précédent		
Išo' (15 s.)	ܝܫܘܥ		lecteur		
Išo' (17 s.)	ܝܫܘܥ		Copiste 2		
Išo' bar 'Ali (9 s.)	ܝܫܘܥ ܒܪ ܥܠܝ	364	Auteur		
Išo' bar Dawid de Ḥaḥ (13-14 s.)	ܝܫܘܥ ܒܪ ܕܘܘܝܕ, ܝܫܘܥ ܒܪ ܟܝܠܐ, Išo' bar Kilo 		Commanditaire		
Išo' bar Ḥošabo (18 s.)	ܝܫܘܥܒܪܚܫܒܐ		Propriétaire précédent		
Išo' bar Šem'un (16 s.)	ܝܫܘܥܒܪܫܡܥܘܢ		Propriétaire précédent		
Išo' bar Yuḥanon (13 s.)	Isa, ܝܫܘܥ, ܥܝܣܐ		commanditaire		
Išo' bar Yuḥanon de Romnah Qasṭra (12-13 s.)	Išo' le Scribe ou le Petit ܝܫܘܥ  ܝܘܚܢܢ (Jean XIV Patriarche d'Antioche)* 	224	Copiste / Illustrateur ; propriétaire ; annotateur		
Išo' de RabbanHormizd (13 s.)	ܐܝܫܥ		Copiste		
Išo' Qnanaya (12-13 s.) 	ܝܫܘܥ ܩܢܢܢܝܐ		Copiste		
Išo'dnaḥ de Baṣra (9 s.)	ܝܫܘܥܕܢܚ	556	Auteur		
Išo'sabran (†620)	ܝܫܘܥܣܒܪܢ		Saint		
Išo'yahb (15 s.)	ܝܫܘܥܝܗܒ, Métropolite d'Arbèles 	Needs ID	Auteur		
Išo'yahb (17-18 s.)	Métropolite gardien du siège oriental  ܝܫܘܥܝܗܒ		Modèle copié du temps de...		
Išo'yahb (18 s.)	(Métropolite d'Édesse )*  ܝܫܘܥܝܗܒ 		Copié du temps de		
Išo'yahb bar Malkon (12-13 s.)	ܝܫܘܥܝܗܒܒܪܡܠܟܘܢ	563	Auteur		
Išo'yahb bar Meqaddam (15 s.)	ܝܫܘܥܝܗܒ ܒܪ ܡܩܕܡ	Needs ID	Auteur	cf. Paris BnF syr. 369	
Išo'yahb III d'Adiabène (580–659)	ܝܫܘܥܝܗܒ	561	Auteur		
Iwannis de Gargar (17 s.)	Jean, ܝܘܚܢܢ		Copiste 2		
Iwannis de Mélitène (1193-1220) 	ܐܝܘܐܢܝܘܣ		ayant participé à la confection du manuscrit		
Jacob, fils d'Isaac, patriarche	ܝܥܩܘܒ		Saint		
Jacques Baradée (†578)	ܝܥܩܘܒܕܐܘܪܗܝ		Saint		
Jacques de Maypherqat	ܝܥܩܘܒ ܡܛܪܐܢ ܡܦܐܪܩܝܢ	179	Auteur		
Jacques de Nisibe (†337/338)	ܝܥܩܘܒܕܢܨܝܒܢ		Saint		
Jacques de Ṣalaḥ (5 s.)	Jacques le Reclus  ܝܥܩܘܒ		Saint		
Jacques de Saroug (†521)	ܝܥܩܘܒ 	42	Auteur / Attribué à		
Jacques de Tagrit (12-13 s.) 	Jacques de Bartella, Sévère bar Šakku, ܝܥܩܘܒ, ܣܘܐܪܐ ܒܪ ܫܟܟܘ	Needs ID	Auteur		
Jacques d'Édesse (†708)	ܝܥܩܘܒ	113	Attribué à		
Jacques le Boiteux	ܝܥܩܘܒ ܚܓܪܐ		Saint		
Jacques le diacre 	ܝܥܩܘܒ	28	Auteur		
Jacques le Mineur (1 s.)	Jacques le Juste   ܝܥܩܘܒ ܐܠܨܕܝܩ		Saint		
Jacques l'Errant			Saint		
Jacques l'Intercis (†421)	ܝܥܩܘܒ ܡܦܣܩܐ		Saint		
Jacques Mirijan de 'Urdnus (†1804)	ܝܥܩܘܒ ܥܘܪܕܢܣܝܐ	297	Auteur		
Jacques, fils d'Alphée (1 s.)	ܝܥܩܘܒ ܐܒܢ ܚܠܦܝ		Saint		
Jacques, fils de Zébédée (1 s.)	ܝܥܩܘܒ ܒܪ ܙܒܕܝ		Saint		
Ja'far-Pascha (16 s.) 			Autre		
Jean (12 s.) 	Maphrien d'Orient, ܝܘܚܢܢ		Copié du temps de…		
Jean bar Aphtonia (†538)	ܝܘܚܢܢ ܕܐܦܬܘܢܝܐ		Saint		
Jean bar Ma'dani (†1263)	(Jean XII Patriarche)*   ܝܘܚܢܢܒܪܡܥܕܢܝ	236	Auteur		
Jean bar Malke (5 s.)	Jean Calybite  ܝܘܚܢܢܒܪܡܠܟ̈ܐ		Saint		
Jean bar Penkaye (7 s.)	ܝܘܚܢܢ ܒܪ ܦܢܟܝܐ̈	821	Auteur		
Jean bar Zo'bi (13 s.)	ܝܘܚܢܢ ܒܪ ܙܘܥܒܝ	823	Auteur		
Jean Chrysostome († 407)	ܝܘܚܢܢܦܡܐܠܕܗܒ	573	Auteur		
Jean Damascène		575	Auteur		
Jean d'Amid (12-13 s.)	 Métropolitain* Mennas   ܝܘܚܢܢ		Commanditaire		
Jean d'Antioche	ܝܘܚܢܢ		Propriétaire précédent 		
Jean d'Asie (6 s.)	Jean d'Éphèse  ܝܘܚܢܢܕܐܣܝܐ	74	Auteur		
Jean de Baṣra	ܝܘܚܢܢ	Needs ID	auteur		
Jean de Bet Rabban (6 s.)	ܝܘܚܢܢ	824	Auteur		
Jean de Carpathos (7 s.)	ܝܘܚܢܐ	Needs ID	Auteur		
Jean de Dalyatha (8 s.)	ܝܘܚܢܢ  Jean l'Ancien    	826	Auteur		
Jean de Ḥarran, Ḥabira et Nisibe (13 s.)	ܐܝܐܘܢܝܣ	Needs ID	auteur		
Jean de Kaphna	ܝܘܚܢܢ ܕܟܦܢܐ		Saint		
Jean de Kefar Sania († ca. 311)	ܝܘܚܢܢ ܕܟܦܪ ܣܢܝܐ		Saint		
Jean de Tella († 538)	ܝܘܚܢܢ ܕܬܠܐ, Jean bar Qursos, ܝܘܚܢܢ ܒܪ ܩܘܪܣܘܣ	50	auteur		
Jean Hesronite (17 s.)	ܝܘܚܢܢ	Needs ID	auteur		
Jean d'Égypte (6 s.)	ܝܘܚܢܢ	Needs ID	auteur		
Jean Issayi, archevêque de Téhéran (20-21 s.)			Propriétaire 		
Jean l'Aumônier (†619)	Jean d'Alexandrie  ܝܘܚܢܢ		Saint		
Jean l'Évèque	ܝܘܽܚܰܢܳܢ ܐܶܦܻܝܣܩܽܘܦܽܐ	Needs ID	Auteur		
Jean le moine	ܝܘܚܢܢ	Needs ID	Auteur		
Jean le Nazirite (6 s.)	ܝܘܚܢܢ		Saint		
Jean le Petit (4-5 s.)	Jean Colobos  ܝܘܚܢܢ ܙܥܘܪܐ		Saint		
Jean le Siloïte			Saint		
Jean le Stylite 		127	Auteur		
Jean Maron 		832	Auteur		
Jean Naqar (9 s.)	ܝܘܚܢܢ	96	Auteur		
Jean VI d'Égypte (12 s.) 	(Patriarche d'Alexandrie)*  ܐܝܘܢܢܝܣ ܕܡܨܪܝܢ		Copié du temps de		
Jean X bar Šušan (†1072)	ܝܘܚܢܢ ܒܪ ܫܘܫܢ	193	auteur		
Jean, évangéliste, fils de Zébédée (1 s.)	ܝܘܚܢܢܒܪܙܒܕܝ		Saint		
Jean-Baptiste (1 s.)	ܝܘܚܢܢ ܡܥܡܕܢܐ		Saint		
Jérôme de Stridon (†420)		857	Auteur		
Jirjis (après 18 s.)	Thomas Almady, évêque de Damas, غريغوريوس, توما الامدي		Propriétaire précédent		
Jirjis Amira (16-17 s.)	ܔܪܔܣ ܐܠܡܪܘܢܝ ܐܒܢ ܥܡܝܪܗ, George Amira	Needs ID	Auteur ; copiste		
Jirjis d'Ehden (16 s.)	Georges ܓܪܓܣ 		Propriétaire précédent		
Jirjis de Rome (18 s.)	Georges ܓܪܓܣ 	Needs ID	Auteur	Cf. Paris BnF syr. 218	
Jirjis ibn Behnan 	ܓܪܓܣ ܐܒܢ ܒܗܢܐܢ		Propriétaire précédent		
Jirjis ibn Ephrem al-Bani (17 s.)	ܔܪܔܣ ܐܒܢ ܐܦܪܐܡ ܐܠܒܐܢܝ		Copiste 		
Jirjis ibn Ḥanna al-Naqar (19 s.)	ܓܝܪܓܣ ܐܒܢ ܚܢܐ ܐܠܢܩܐܪ		copiste		
Jirjis ibn Ilya 			Annotateur		
Jirjis ibn Mikha (19 s.)	Georges, ܓܪܓܣ		Propriétaire précédent		
Job (16 s.)	ܐܝܘܒ		autre		
Job de Ḥabsenas	ܐܝܘܒ ܕܚܒܣܝܢܣ	Needs ID	Auteur		
Joseph	ܝܘܣܝܦܘܣ		Saint		
Joseph Audo	Patriarche de Mossoul ܝܘܣܦ ܐܘܕܐ		traducteur		
Joseph, fils de Jacob	ܝܘܣܦܒܪܝܥܩܘܒ		Saint 		
Jules de Rome (4 s.)	ܝܘܠܝܘܣ	Needs ID	auteur		
Julien Saba († 377)	ܝܘܠܝܢܐܣܒܐ		Saint		
Juliette (début 4 s.) 	ܝܘܠܝܛܐ		Sainte		
Justinien de Tours (17 s.)	Michel Fevre ou Febure, ميخايل	Needs ID	auteur		
Kalaf du monastère des Syriens (16 s.)			autre		
Kamis bar Qardaḥe (15 s.)	ܟܡܝܣ ܒܪ ܩܪܕ̈ܚܐ	587	Auteur		
Kidr ibn Hormuzd de Mossoul (18 s.)	ܟܼܕܪ		Copiste		
Kuna (18 s.)	ܟܘܢܐ		Autre		
Laurent et Agrippa, martyrs (début 4 s.)			Saint		
Lazare			Saint		
Lazare (12 s.)	ܠܥܙܪ		Autre		
Lazare (13-14 s.)	ܠܥܙܪ		Propriétaire précédent		
Lazare (8 s.) 	ܠܥܙܪ		Copiste		
Lazare bar Sabta (9 s.)	Philoxène de Bagdad, ܦܝܠܠܘܟܣܝܢܘܣ, ܠܥܙܪ	149	auteur		
Lazare bar Yawsep de 'WDRNS (12 s.)	ܠܥܙܪ		Propriétaire précédent 		
Lebrun, Pierre (†1729) 			Propriétaire précédent		
Léon XIII Pape (1810-1903)	ܠܹܐܘܢ		Copié du temps de		
Léonce de Néapolis (†ca.670)	ܠܐܘܢܛܝܘܣ   Léonce de Chypre  	Needs ID	Auteur		
Léonce et Publius (1 s.)	ܠܐܘܢܛܝܘܣ ܘܦܘܦܠܝܘܣ		Saint		
Leroux Deshautesrayes, Michel Ange André (18 s.) 			Propriétaire précédent		
Louis XIV	roi de France, ܣܠܛܐܢ ܦܪܢܣ		Destinataire d'un texte		
Louis XV	roi de France		Destinataire d'un texte		
Louis-Henri de Loménie de Brienne (1635-1698)	ܟܢܬܝ ܕܒܪܝܐܢܗ		Destinataire d'un texte		
Luc, évangéliste (1 s.)	ܠܘܩܐ		Saint		
Mabryk (fin 15 s.)	ܡܒܪܝܟ		Copiste		
Macaire d'Alexandrie (4 s.)	ܡܩܪܝܣ	Needs ID	Attribué à / saint	Beware : Macarius Alexandrinus is different from Macarius / Symeon, author of the Macarian Homilies (Syriaca ID 601)	
Macaire de Jérusalem (4 s.)	ܡܩܪܝܣ		Saint		
Macaire le Grand (4 s.)	Macaire de Scété ܡܩܪܝܣ ܪܒܐ	856	Auteur / saint		
Mahdukt, sultane (†319 ?)	 ܡܗܕܘܟܬܝ      ܡܗܕܘܟ		Sainte		
Mahris (18-19 s.)	ܡܗܪܝܣ		Autre		
Ma'in de Singar (4 s.)	ܡܥܝܢ		Saint		
Malchus de Clysma (4-5 s.)	ܡܠܟܐ ܩܠܘܙܡܝܐ		Saint		
Malka (fin 15 s.)	ܡܠܟܐ		Copiste		
Malka bar Marqos (13-14 s.)	ܡܠܟܐ		Propriétaire précédent		
Malkisadaq ibn Ya'qub (16 s.)	ܡܠܟܝܣܐܕܐܩ, ܡܠܟܝܙܕܝܩ, ܡܠܟܝܫܐܨܕܐܩ		Copiste		
Mammès (3 s.)	ܡܐܡܐ		Saint		
Manṣur 	ܡܢܨܘܪ		autre		
Manṣur bar 'Abd al-Karim de Mossoul (19 s.)	ܡܢܨܘܪܒܪܥܒܕܐܠܟܪܝܡ		Copiste		
Manṣur bar Qulius	ܡܢܨܘܪܒܪܩܘܠܝܘܣ		Propriétaire précédent		
Manṣur bar Zayid (13 s.)	ܡܢܨܘܪܒܪܙܐܝܕ		Copiste		
Manṣur ibn Ibrahim (16 s.)	ܡܢܨܘܪ		autre		
Maqbi bar Kaskun d'Amid (17 s.)	ܡܩܒܝ ܒܪ ܟܣܟܘܢ		Copiste		
Marc (12 s.)	 Patriarche d'Egypte ܡܪܩܘܣ		Autre		
Marc de Tarmaqa (4 s.)	ܡܪܩܘܣܐܒܝܠܐܕܒܛܘܪܐܕܬܪܡܩܐ		Saint		
Marc et Gaspard d'Orient	ܓܣܦܪ, ܡܐܪܩܐ		Saint		
Marc le solitaire			Saint		
Marḥasan 	ܡܪܚܣܢ		Famille		
Mari de Bet Sahde	ܡܪܝܕܒܝܬܣܗܕ̈ܐ		Saint		
Mariam (Shamoné)	ܫܡܘܢܝ, Mère des Maccabées		Saint		
Mariam bart Eliya (19 s.)	ܡܪܝܡ		annotateur		
Marie (1 s.)	Vierge Marie   ܡܪܝܡ	624	Sainte		
Marie l'Égyptienne	ܡܪܝܐܐܓܝܦܛܝܬܐ		Sainte		
Marie, martyre (3-4 s.)	ܡܪܝܐ		Saint		
Marina	ܡܐܪܝܐ		Sainte		
Maris-Thérèse d'Autriche (1638-1683)	Reine de France		Destinataire d'un texte		
Marqws (début 18 s.)	ܡܪܩܘܣ		Copiste		
Marqws bar Yuḥanon bar Ḥasan (16 s.)	Marc, ܡܪܩܘܣ		famille du copiste		
Marqws de Mar-Aḥa (12-13 s.) 	ܡܪܩܘܣ Marc		commanditaire		
Marthe (†341)	ܡܪܬܐ		Saint		
Martinien (4-5 s.)	ܡܪܛܢܝܢܐ		Saint		
Martyrius (Sahdona) (7 s.)	ܡܪܛܘܪܝܣ	711	Auteur		
Martyrs de Bet Slok	ܒܝܬ ܣܠܘܟ		Saint		
Martyrs de Najran (†523)	Martyrs Ḥimyarites   ܚܡܝܖ̈ܝܐ  ܒ̈ܢܝ ܢܝܓܪܢ		Saint		
Martyrs du Ṭur-Berain (†319 ?)	ܣܗܕ̈ܐ ܒܛܘܪ ܒܪܐܝܢ		Saint		
Maruta (19-20 s.)	ܡܪܘܬܐ		Copiste		
Maruta bar Ḥabib	ܡܪܘܬܐ ܒܪ ܚܒܝܒ		Autre		
Maruta de Tagrit (†649) 	ܡܪܘܬܐ ܕܬܐܓܪܝܬ	93	Auteur		
Maryam (13 s.)	ܡܪܝܡ		Propriétaire précédent		
Maryam bart Amat (18 s.)	ܡܪܝܡ ܒܰܪܬ ܗܿܐܡܬ		Financé par		
Mas'ud appelé Bar Kardiš (13 s.)	ܡܣܥܘܕ ܕܡܬܝܕܥ ܒܪ ܟܪܕܝܫ		Propriétaire précédent		
Mas'ud du Ṭur 'Abdin (15 s.)		279	Auteur		
Mas'ud ibn Barṣawma ibn Isaac de Qalu (19 s.)	ܡܣܥܘܕܒܢܒܪܨܘܡܐܒܢܐܣܚܩ		Annotateur		
Matay (4 s.) 	ܡܬܝ Matthieu		Saint		
Matthieu, apôtre (1 s.)	ܡܐܬܝܘܣ		Saint		
Maurice (†602)	ܡܘܪܝܩܝ		Saint		
Maxime et Domèce (5 s.)	ܡܐܟܣܝܡܘܣ, ܕܘܡܐܛܝܘܣ		Saint		
Mazarin, Jules	Cardinal Mazarin, ܡܐܙܪܝܢ		Destinataire d'un texte		
Menasce, Jean de (1902-1973)			Propriétaire précédent 		
Michel d'Amid (avant 16 s.)	ܡܝܟܐܝܠ	Needs ID	Auteur		
Michel du désert d'Egypte (15 s.)	ܡܝܟܐܝܠ		Copiste 2		
Michel II de Mélitène 	ܡܝܟܐܝܠ	223	Auteur		
Michel le Syrien (†1199)	(Patriarche)*  ܡܝܼܟܐܝܠܪܒܐ		Copié du temps de		
Michel, disciple d'Awgin	ܡܝܟܐܝܠ 	Needs ID	Attribué à		
Mikail (16 s.)	ܡܝܟܐܝܠ		Copiste 2		
Mikail (18-19 s. ?)	Métropolite, ܡܝܟܐܝܠ		Annotateur		
Mikail de Baqufa (19 s.)	 Patriarche ܡܝܟܐܝܠMichel 		Autre		
Mikail de Mar-Siméon (12 s.)	ܡܝܟܐܝܠ, Michel 		restaurateur		
Mikail dit Gindiši' (11 s.)	ܡܝܟܐܝܠ ܓܢܕܝܫܝܥ, Michel		commanditaire		
Mikail Romanos (19 s.)	Michel ܡܝܟܐܝܠ ܪܘܡܢܘܣ		Copiste		
Miles, Abraham et Sinoi (4 s.) 	ܡܝܠܣ, ܐܒܪܗܡ, ܣܝ		Saint		
Mirijan le prêtre	ܡܝܪܝܓܐܢ Evêque Athanase	Needs ID	Auteur		
Mirza de Midun	ܡܝܪܙܐ ܡܕܝܘܝܐ	Needs ID	Auteur		
Moïse bar Kepha († 903)	ܡܘܫܐܒܪܟܐܦܐ	173	Auteur		
Moïse l'Éthiopien	ܡܘܫܐܟܘܫܝܐ		Saint		
Moïse, prophète	ܡܘܫܐ		Saint		
Mubarakša de Mar-Pétion près de Mardin (17 s.)			Propriétaire		
Murad (17 s. ?)	ܡܘܪܐܕ		Copiste 		
Murad IV, sultan (17 s.)	ܡܘܪܐܕ		Copié du temps de		
Muše (17 s.)	ܡܘܫܐ		Copiste 2		
Muše bar Barṣawma d'Alep (17 s.)	ܡܘܫܐ		commanditaire		
Muše bar kotubo d-Tamrza (20 s.)	ܡܘܫܐ		Annotateur		
Muše de Mardin (16 s.)	ܡܘܫܐ, ܡܘ݀ܫܐ ܡܝܛܪܘܦܪܠܝܛܐ ܕܨܘܪܐ Moïse, Moïse de Ṣora 		Imprimeur 		
Muše ibn al-Kun (17 s.)	ܡܘܫܐ Moïse		Annotateur		
Nagim bar Shams bar Abulfaraj bar Bahnan bar Qasis (14 s.)	Nagim ܢܓܡ ܒܪ ܫܡܣܐ ܒܪ ܐܒ݁ܘܐܠܦܪܓ݁ ܒܪܒܪܗܰܐܢ ܒܪܩܣܝܣܢ		Copiste		
Narsaï (5 s.)		650	Auteur		
Naṣir ibn al-Abrwṭis (16 s.)	ناصير ابن الابروطس		Copiste		
Nau, François (19-20 s.)		652	Auteur / Copiste / Traducteur / Annotateur		
Nazif Khazin (fin 17 s.) 	Prince des maronites du Mont Liban	Needs ID	Auteur		
Nestorius (5 s.)	ܢܣܛܘܪܝܣ 	655	Auteur		
Nicolas de Myre (4 s.)			Saint		
Nil d'Ancyre (†après 430)	ܢܝܠܘܣ, Nil le Solitaire	657	Auteur		
Noé de Baqupha 		Needs ID	Auteur	cf. Paris BnF syr. 180	
Onésima	ܐܢܣܝܡܐ		Sainte		
Onésime, disciple de Paul	ܐܘܢܝܣܝܡܘܣ		Saint		
Onestos (17 s.)	ܐܢܣܛܙܣ		Copiste		
Origène (†254)		Needs ID	Auteur		
Pachas de Gagim	ܦܟܐܣ ܕܓܓܡ	Needs ID	Auteur		
Pachôme (4 s.)	ܦܟܘܡ		Saint		
Pallade d'Hélénopolis	ܦܠܕܝܘܣ	668	Auteur		
Pantaléon et Hermolaos (4 s.)	ܦܢܛܠܐܘܢ, ܐܪܡܠܐܘܣ		Saint		
Pantaléon, médecin martyr († ca. 305)	Buṭlana ܦܢܛܠܐܘܢ		Saint		
Paphnuce d'Égypte (†360) 	ܦܦܢܘܛܝܣ		Saint		
Paphnuce le Grand (†303)	ܦܦܢܘܛܝܣ		Saint		
Papos (P'PWS)	ܦܐܦܘܣ		Saint		
Parnasu Babe (20 s.)	ܦܪܢܣܘ ܒܒܐ		famille du copiste		
Paul de Tella (7 s.)	ܦܘܠܘܣ		Traducteur		
Paul de Thèbe (4 s.)	ܦܘܠܘܣ		Saint		
Paul le simple	ܦܘܠܐ Disciple d'Antoine  		Saint		
Paul V (†1621)	ܦܘܠܘܣ Pape 		Copié du temps de		
Paul, apôtre (1 s.)	ܦܘܠܘܣ		Saint		
Paula et Jean (5 s.)	ܦܘܠܐܐܦܝܣܩܘܦܐ, ܝܘܚܢܢܩܫܝܫܐ		Saint		
Pawlos (13 s.)	Paul  ܦܘܠܣ		Copiste		
Pawlos (19 s.)	Supérieur général des monastères chaldéens, ܦܘܠܘܣ, Paul		Copié du temps de…		
Pawlos bar Yoye bar Yaqiro de Tagrit (10 s.)	ܦܘܠܣ, Paul 		Propriétaire précédent		
Pécoul, A. 			Propriétaire précédent		
Peiresc, Nicolas-Claude Fabri (1580-1637 ; seigneur de)			Propriétaire précédent		
Pélagie, pénitente d'Antioche	ܦܠܓܝܐ		Saint		
Péthion, martyr († 447)	ܦܬܝܘܢ		Saint		
Pétis de La Croix, François (1653-1713) 			destinataire		
Peṭros (15 s.)	Patriarche, ܦܛܪܘܣ		Commanditaire		
Peṭros (fin 19 s.) 	Chef général des monastères, ܦܛܪܝܣ		Copié du temps de…		
Peṭros bar Rafu Al'w' (19 s.)	   ܦܛܪܘܣ, ܪܦܘܐܠܥܘܥ		Commanditaire		
Peṭros bar Tawma Katula (19 s.)	ܦܛܪܘܣ ܒܪ ܬܐܘܡܐ ܟܬܘܠܐ	Needs ID	Auteur		
Peṭros bar Ya'qub, Ḥariri	ܦܛܪܘܣ		Copiste		
Peṭros bar Yawsep bar Yuḥanon bar Esṭefanos bar Abraham de Bet Gangi, de Telkef (19-20 s.)	  Buṭros   ܒܛܪܘܣ ܒܪ ܝܘܣܦ ܐܠ ܣܬܦܢܘܣ ܦܛܪܘܣ ܒܪ ܝܘܣܦ ܒܪ ܝܘܚܢܢ ܒܪ ܐܣܛܦܢܘܣ ܒܪ ܐܒܪܗܡ ܡܢ ܕܒܝܬ ܓܢܓܝ Pierre l'écolier		Copiste		
Peṭros bar Yuḥanon bar-Šeref (15-16 s.)	Pierre, ܦܛܪܘܣ		copiste		
Peṭros ibn Tawma (16-17 s. ?)	ܒܛܪܘܣ ܐܒܢ ܬܘܡܐ   Buṭros     		Propriétaire précédent 		
Philémon 	ܦܝܠܝܡܘܢ		Saint		
Philemon, Karolis, Apolonis et Aryanos (3-4 s.)	ܦܝܠܝܡܘܢ, ܐܦܠܘܢܝܘܣ, ܟܪܠܝܣ, ܐܪܝܢܘܣ		Saint		
Philippe (19-20 s.)	Supérieur temporaire des couvents		Copié du temps de		
Philippe et Pierre, apôtres (1 s.)	ܦܝܠܝܦܘܣܘܦܛܪܘܣ		Saint		
Philippe, apôtre (1 s.)	ܦܝܠܝܦܘܣ		Saint		
Philippos bar Aziz (19 s.)	ܦܝܠܝܦܘܣ		Commanditaire		
Philothée	ܦܠܐܬܘܣ	848	Auteur		
Philoxène de Ḥardin (14-15 s.)	ܦܝܠܘܟܣܝܢܘܣ		Copié du temps de 		
Philoxène de Ḥardin (16 s.)	ܦܝܠܘܟܣܝܢܘܣ		Copiste		
Philoxène de Mabboug (†523)	ܦܝܠܘܟܣܝܢܘܣܕܡܒܘܓ		Saint		
Picon, Jean-Baptiste Louis (†1727) 	Comte d'Andrezel		Propriétaire précédent		
Picques (17 s.) 			Annotateur		
Pie IX Pape (1792-1878)	ܦܝܘܣ		Copié du temps de		
Pie XI Pape (1857-1939)	ܦܝܘܣ		Copié du temps de…		
Pierre d'Alexandrie (†311)	ܦܛܪܘܣ	Needs ID	auteur		
Pierre et Paul, apôtres (1 s.)	ܦܘܠܘܣ    ܦܐܛܪܘܣ		Saint		
Pierre et Thaddée (1 s.)	ܦܐܛܪܘܣ ܐܕܝ		Saint		
Pierre le Publicain (6-7 s.)	ܦܛܪܐ ܪܝܫܡ̈ܟܣܐ		Saint		
Pierre l'Ibère (†488-91)	ܦܛܪܘܣ ܐܝܒܪܝܐ		Saint		
Pierre, apôtre (1 s.)	ܦܛܪܘܣ		Saint		
Pierre, patricien d'Afrique			Saint		
Pinḥas (4-5 s.)	ܦܝܢܚܣ		Saint		
Platon, martyre	ܦܠܘܛܝܢܐ		Saint		
Pognon Henri (1853-1921)	(Consul de France à Alep)* (Consul de France à Bagdad)*  (ܦܘܢܝܘܢ)*		Propriétaire précédent / Destinataire / Commanditaire / Annotateur		
Porphyre de Tyr (3-4 s.)	ܦܘܪܦܝܪܝܘܤ	Needs ID	Auteur		
Posi (†341)	ܦܘܣܝ		Saint		
Probe, Taraque et Andronic (†304)	ܦܪܘܒܘܣ ܘܛܐܪܐܟܘܣ ܘܐܢܕܪܘܢܝܩܘܣ		Saint		
Prochore		Needs ID	Auteur		
Proclus de Constantinople (5 s.)	ܦܪܘܩܠܘܣ	688	auteur		
Protonice, épouse de Claude (1 s.)	ܦܪܛܘܢܝܩܝ		Sainte		
Pseudo-Denys l'Aréopagite (5 s.)	ܕܝܘܢܘܣܝܣ	452	Auteur		
Pseudo-Nonnos		Needs ID	Auteur		
Qandida			Saint		
Qardag, martyr (†359 ?)	ܩܪܕܓ		Saint		
Quaresmio Francesco (17 s.)			Annotateur		
Qufar de Mar-Barṣawma (fin 12 s.) 	ܩܘܦܪ		Relieur / Financé par…		
Quriaqos (15 s.)	Cyriaque, ܩܘܪܝܩܘܣ		Propriétaire précédent		
Quriaqos (†1895)  	قوريقوس		autre		
Quriaqos (19 s.)	ܩܘܪܝܩܘܣ		Copiste		
Quriaqos bar Yoye bar Yaqiro de Tagrit (10 s.)	 Cyriaque ܩܘܪܝܩܘܣ		Propriétaire précédent		
Quriaqos de Manṣuriya (16 s.)	Cyriaque, ܩܘܪܝܩܣ		copiste		
Quriaqos du monastère des Syriens (16 s.)	Cyriaque, ܩܘܪܝܩܘܣ		autre		
Quriaqos du Mont Liban (16 s.)	Cyriaque, ܩܘܪܝܩܘܣ		autre		
Qurillos (13 s. ?)	Cyrille, ܩܘܪܝܠܠܘܣ  		Relieur		
Qurillos Ayawanis de Karkar (17 s.)	Métropolite de Ḥisn Ziyad, ܩܘܪܝܠܠܘܣ, Cyrille		autre		
Qurillos de Mar-Mattaï (19 s.)	Cyrille, ܩܘܪܝܠܠܘܣ, Métropolite Eliyas de Mossoul, Supérieur du monastère de Mar-Mattaï, ܐܠܝܐܣ		Copié du temps de		
Qusṭanṭin bar Ya'qub (12-13 s.)	 Constantin  ܩܘܣܛܢܛܝܢ ܒܪ ܝܥܩܘܒ		Copiste		
Rabbi Baba (19 s.)			Propriétaire précédent		
Rabbula (†436)	ܪܒܘܠܐ	944	auteur		
Raymond Lulle (1232-1315)	ܪܐܝܡܘܢܕܘܤ	Needs ID	Auteur		
Réchabites	ܒܢܝ̈ ܝܘܢܕܒ ܒܪܪܟܒ		Saint		
Renaudot, Eusèbe († 1720)			Annotateur		
René IV de Mailly († 1695)	ܐܡܝܪ ܕܡܘܝܠܝ		Destinataire d'un texte		
Richard de Ruffey (18 s.)			Propriétaire précédent		
Rizqallah	ܪܙܩܠܠܗ	Needs ID	Auteur		
Romanos d'Alqoš (19 s.)	ܪܘܡܢܘܣ		Copiste du modèle		
Romanos de Jérusalem (12 s.)	ܪܘܡܢܘܣ		Copiste		
Romanos, martyr (†303)	ܪܘܡܢܘܣ		Saint		
Ruben de Mar-Ṣaliba (13 s.)			Commanditaire		
Rubil	ܪܘܒܝܠ		Saint		
Šaba bar Ḥanu Ya'qub Šamsuko et Barbara sœur d'Ibrahim (fin 19 s.) 	ܫܐܒܐ		Famille du copiste 		
Saba Gušnazdad (5 s.)	ܣܒܐ ܓܘܫܢܐܙܕܐܕ		Saint		
Sabrišo' de Bet Qoqa (7 s.)	ܣܒܪܝܫܘܥ ܕܒܝܬ ܩܘܩܐ		Saint		
Sabrišo‘ de Ḥisn Kepha (15 s.)	ܣܒܪܝܫܘܥ ܕܚܣܢ ܟܐܦܐ		Copiste		
Šabur, Isḥac, Ma’na, Abraham et Šem'un (†340) 	ܫܒܘܪ, ܐܝܣܚܩ, ܡܥܢܐ, ܐܒܪܗܡ, ܫܡܥ		Saint		
Ṣadr (19 s.)			Propriétaire précédent		
Sahda (16 s.)	ܣܗܕܐ		autre		
Šahdost (†342)	ܫܗܕܘܣܬ		Saint		
Sa'id (12-13 s.)	ܣܥܝܕ		ayant participé à la confection du manuscrit		
Sa'id ibn Baṭriq (10 s.)	Eutychius ܣܥܝܕ ܐܒܢܒܛܪܝܩ	Needs ID	Auteur	cf. Paris BnF syr. 204	
Sakah ibn Peṭros, intendant de Mart-Šmuni, église de Barṭella (19 s.) 	ساكه		Commenditaire		
Ṣaliba (13 s.)	ܨܠܝܒܐ		Copiste		
Šaliba (15 s.)	ܫܠܝܒܐ		Copiste 2		
Ṣaliba (16 s.)	ܨܠܝܒܐ		Restaurateur		
Ṣaliba bar Dawid	ܨܠܝܒܐ	Needs ID	Auteur		
Ṣaliba bar Šem'un de Saman	ܨܠܝܒܐ		Propriétaire précédent 		
Ṣaliba bar Tawma de Ayḥel	ܨܠܝܒܐ ܐܝܚܠ 		annotateur		
Ṣaliba de Mar-Barṣawma (fin 12 s.)	ܨܠܝܒܐ		Commanditaire		
Ṣaliba de Slok (13 s.)	ܨܠܝܒܐ, Disciple de Mar Sabrišo'		Propriétaire précédent		
Ṣaliba-Zeka (9 s.)	ܨܠܝܒܐ ܙܟܐ		Copiste		
Ṣalibi de Damas (17 s.)	ܨܠܝܒܝ		copiste		
Salomon (roi)	ܣܠܝܡܐܢ	Needs ID	Attribué à	Same pseudo-author as the author of Odes of Salomon, Psalms, Testament…	
Salomon de Baṣra (13 s.)	Šlemon de Perat de Mayšan Salomon d’Akhlat ܫܠܝܡܘܢ ܕܦܪܬ ܕܡܝܫܢ	745	Auteur		
Sam'an al-Ḫarraz (10 s.)	ܣܡܥܐܢ ܐܠܟܪܐܙ		Saint		
Samuel	ܫܡܘܐܝܠ		Propriétaire précédent 		
Samuel de Qartmin († ca. 410)	ܫܡܘܐܝܠ ܕܩܪܬܡܝܢ		Saint		
Samuel Giamil (19-20 s.)	Supérieur général des couvents ܫܡܘܐܝܠ ܓܡܝܠ		Copié du temps de		
Samuel, disciple de Barṣaumo (5-6 s.)	ܫܡܘܐܝܠ 	Needs ID	Attribué à	cf. Add. 12174	
Saqa (fin 19 s.)  	ܣܐܩܐ		Autre		
Sargis	ܣܪܓܝܣ		Annotateur		
Sargis (16 s.)	ܣܪܓܝܣ, Serge		copiste		
Sargis (17 s.)	Serge  ܣܪܓܝܣ		Copiste		
Sargis (fin 13 s.)	Serge  ܣܪܓܝܣ		Restaurateur		
Sargis bar Waḥle (15-16 s.)	Serge d'Azerbaidjan  ܣܪܓܝܣ ܕܐܕܘܪܒܝܓܢ	717	Auteur		
Sargis d'Amphiator	ܣܪܓܝܣ, ܐܡܦܝܐܛܘܪ, Serge 	Needs ID	auteur		
Sargis de Bet Huzaye et Abraham de Kaškar (6 s.)	ܐܒܪܗܡܡܢܐܬܪܐܕܟܫܟܪ      ܣܪܓܝܣ ܡܢܐܬܪܐ ܕܒܝܬܗܘ̈ܙܝܐ		Saint		
Sargis de Rome (17 s.)	Serge, ܣܪܓܝܣ		Copiste		
Sargis de Rustaqa (17 s.)	ܣܪܓܝܣ		Copié du temps de		
Sargis du Ṭur ‘Abdin (15-16 s.?)	ܣܪܓܝܣ ܕܛܘܪ ܥܒܕܝܢ		Copiste		
Sargis, économe du monastère des Moines sincères (8 s.)	ܣܪܓܝܣ		Copié du temps de 		
Sarkis 	Serge   ܣܪܟܝܣ		traducteur		
Sarkis (13-14 s.?)	Serge   ܣܪܟܝܣ		Copiste		
Sarkis ibn al-Muḥasib de Mar-Šaliṭa (17 s.)	ܣܪܟܿܝܣ ܐܒܢ ܐܠܡܚܐܣܒ		Copié du temps de		
Saru	ܣܐܪܘ		Famille du copiste 		
Ṣary 	ܨܪܝ		annotateur		
Schickard Wilhelm (1592-1635) 			Propriétaire précédent 		
Šeba bar Pawlos et Iazdiyah (17 s.)	ܫܒܐܒܪܦܘܠܣ		Copiste		
Séguier, Pierre (1588-1672)			Propriétaire précédent 		
Šem'un (12 s.)	ܫܡܥܘܢ		Copiste		
Šem'un (15 s.) 	ܫܡܥܘܢ, Catholicos patriarche de l'Orient  		Modèle copié du temps de		
Šem'un (17 s.)	ܫܝܡܥܘܢCatholicos d'Orient		Copié du temps de		
Šem'un (8 s.)	ܫܡܥܘܢSiméon évêque du monastère des Moines sincères		Copié du temps de…		
Šem'un (8 s.)	ܫܡܥܘܢ, Siméon prêtre et chef du monastère des Moines sincères 		Copié du temps de…		
Šem'un (9 s.)	ܫܡܥܘܢ, Siméon		ayant participé à la confection du manuscrit		
Šem'un (fin 19 s.)	ܫܡܥܘܢ, Catholicos patriarche de l'Orient, Rubil, ܪܘܒܝܠ 		Copié du temps de…		
Šem'un bar Ḥaya (†1194)	ܫܡܥܘܢ, Siméon		Copiste / Illustrateur		
Šem'un bar Išo' (18 s.)	ܫܡܥܘܢ		Propriétaire précédent 		
Šem'un de Kafr 'Abdin	ܫܡܥܘܢܡܢܟܦܪܥܒܕܝܢ		Saint		
Šem'un de Kafrsalta (13 s.)	ܫܡܥܘܢ, Siméon 		Copiste		
Šem'un de Mar-Ṣaliba (13 s.)	ܫܡܥܘܢ, Siméon 		Commanditaire		
Šem'un IV (†1538)	ܫܡܥܘܢ  Patriarche catholique de l'Orient 		Copié du temps de 		
Šem'un, disciple de Rabban Yozadaq	ܫܡܥܘܢSiméon 	Needs ID	Auteur		
Sept dormants d'Éphèse (3 s.)	ܬܡܢܝܐܛܠܝܐܕܐܣܗܕܘܒܐܦܣܘܣ		Saint		
Sept martyrs de Samosate	ܫܒܥܐ ܣܗ̈ܕܐ ܒܫܡܝܫܛ		Saint		
Sérapion 	ܣܪܦܘܢ		saint		
Sérapion de Thmuis 		Needs ID	Attribué à		
Sérapion le Sindonite (4 s.)	ܣܪܐܦܝܘܢ		Saint		
Serge de Reš'ayna		49	Auteur		
Serge et Bacchus, martyrs (3-4 s.)	ܣܪܓܝܣ, ܒܟܘܣ		Saint		
Serge Pierre (16 s.)	Patriarche maronite d'Antioche ܣܪܓܝܣ	Needs ID	Auteur		
Sergius (17 s.)	Archevêque de Damas, ܣܪܓܝܘܣ		Destinataire d'un texte		
Sévère (16 s.)	ܘܣܐܘܝܪܐ		autre		
Sévère bar Yuḥanon (15 s.)			copiste		
Sévère d'Antioche († 538)	(Patriarche)*  ܣܘܝܪܘܣ	51	Auteur / saint		
Sévère Sébokt († après 665)	Sévère de Nisibe ܣܗܪܐ ܣܒܘܟܬ ܢܨܝܒܢܝܐ	99	Auteur		
Šidad bar Šidad (fin 19 s.)	ܫܝܕܕ		Copiste		
Silvestre de Sacy, Antoine-Isaac (1758-1838)			Annotateur		
Sim'an ibn 'Abd al-Aḥad de Mardin (17 s.)	سمعون, Simon		lecteur		
Sim'an ibn 'Isa de Séert (19-20 s.)	Siméon ܫܡܥܘܢ		Annotateur		
Sim'an ibn Khalil ibn Maqara (12 s.) 		Needs ID	Auteur		
Siméon bar Ṣabba'e (†341)	ܫܡܥܘܢ		Saint		
Siméon de Bet Aršam (6 s.)	ܫܝܡܥܘܢ ܕܒܝܬ ܐܪܫܡ  Šem'un de Bet Aršam  	53	Auteur		
Siméon de Qartmin (†433)	ܫܡܥܘܢ ܕܩܪܬܡܝܢ		Saint		
Siméon de Samosate (8 s.)	ܫܡܥܘܢ ܕܫܡܝܫܛ	116	Auteur		
Siméon de Tibérias	ܫܡܥܘܢ		Propriétaire précédent		
Siméon des Olives (†734)	ܫܡܥܘܢ ܕܙܝ̈ܬܐ		Saint		
Siméon le fou			Saint		
Siméon le Potier (6 s.)	 ܫܡܥܘܢ ܩܘܩܝܐ, ܫܡܥܘܢ ܓܐܫܝܪ, Šem'un de Gišir Šem'un Quqaya 	37	Auteur		
Siméon le Stylite (†459)	ܫܡܥܘܢ ܕܐܣܛܘܢܗ	744	Attribué à		
Simon le Cananéen	ܣܝܡܢܐܒܢܐܟܠܐܘܒܐ		Saint		
Šlemun (19-20 s.)	Métropolite d'Amid*  ܫܠܝܡܘܢ		Copié du temps de		
Šlemun bar Dawud (17 s.)	ܫܠܝܡܘܢܒܪܕܘܘܝܕ		Copiste		
Šlemun bar Katu (18 s.)	ܫܠܝܡܘܢ		Propriétaire précédent 		
Šlemun bar Yawsep bar Dayanos  (15-16 s.)	ܫܠܝܡܘܢܒܪܗܕܝܘܣܦܒܪܗܕܝܐܢܘܣ		Copiste		
Šlemun de Mardin (15 s.)	ܫܠܝܡܘܢܡܢܡܪܕܝܢ		Copiste 2		
Šlemun de Qartmin (12 s.)	Salomon, ܫܠܡܘܢ		ayant participé à la confection du manuscrit		
Smith Morton (20 s.)			Propriétaire précédent 		
Šmu'il bar Hormizd de Telkef (20 s.)	Samuel, ܫܡܘܐܝܠ		copiste		
Šmuni 	ܫܡܘܢܝ		autre		
Sophie (3-4 s.)	ܣܘܦܝܐ		Sainte		
Sophie, martyre de Rome (2 s. ?)	Pistis, Elpis, Agape ܐܓܦܐ ܗܠܦܝܣ ܣܘܦܝܐ ܦܣܛܝܣ 		Saint		
Sophrone de Jérusalem (†634)		757	Attribué à		
Stéphanos (18 s.)	ܐܣܛܦܐܢܘܣ		Copiste		
Stratonice et Seleucus (3-4 s.) 	ܐܣܛܪܛܘܢܝܩܝ, ܣܠܘܩܘܣ		Saint		
Šubḥalmaran (6-7 s.)	Évêque de Karka de Bet Slok, ܫܘܒܚܐ ܠܡܪܢ	746	Auteur		
Sulaman (13 s.)	ܣܘܠܡܐܢ		Destinataire		
Suzanne, moniale	ܫܘܫܢ		Saint		
Symmaque		761/842?	Auteur	Cf. Damas 12/17 f. 69-70 Author of the life of Abel	
Taïsia 	ܛܗܣܝܐ		Saint		
Taj al-Din ibn Abu al-Faraj	ܬܕܓܐܠܕܝܢ		Fils du propriétaire précédent		
Ṭalya (†421)	ܛܠܝܐ		Saint		
Ṭalya (18 s.)	طليا		Lecteur		
Ṭalya (19 s.)	ܛܠܝܐ		Restaurateur		
Tarbo (†341)	ܬܪܒܘ		Saint		
Tawma 	ܬܐܘܡܐ, Thomas		Propriétaire précédent		
Tawma (19 s.)	Catholicos, Behnan   ܒܗܢܐܢ ܬܐܘܡܐ		Copié du temps de		
Tawma bar Israil bar Gamo d'Alqoš (19 s.)	Thomas, ܬܐܘܡܐ ܒܪ ܝܣܪܝܠ ܒܪ ܓܡܐ		Copiste 		
Tawma bar Ṣaliba de Midyat (16 s.) 	Thomas, ܬܐܘܡܐ		Propriétaire précédent		
Tawma bar Yawsep (11 s.)	ܬܐܘܡܐ, Thomas		commanditaire		
Tawma bar Yoye bar Yaqiro de Tagrit (10 s.)	Thomas ܬܐܘܡܐ		Propriétaire précédent		
Tawma de Damas (16 s.)	Thomas, ܬܐܘܡܐ		commanditaire		
Tawma du Tur ‘Abdin (13 s.?)	Thomas  ܬܐܘܡܐ ܕܡܢܐܬܪܐ ܕܛܘܪ ܥܒܕܝܢ		Propriétaire précédent		
Tawma ibn Fadl-Allah de Ḥomṣ (16 s.)	Thomas, ܬܐܘܡܐ		Propriétaire précédent		
Tawma ibn Ibrahim ibn Naṣir (16 s.)	ܬܘܡܐ, Thomas 		Commanditaire		
Tawma ibn Naṣir ibn Qandis 	Thomas, ܬܐܘܡܐ		Propriétaire précédent		
Teka (18 s.)	ܬܟܐ		Financé par		
Thècle (1 s.)	ܬܩܠܐ		Saint		
Théodore Abu Qurra († après 829) 		782	Attribué à		
Théodore bar Abu al-Faraj de Ṣalaḥ (12-13 s.) 	ܬܐܘܕܘܪܘܣ		Copiste 		
Théodore bar Koni (fin 8 s.)	ܬܐܘܕܘܪܘܣ ܕܟܫܟܪ ܒܪ ܟܘܢܝ	783	Auteur		
Théodore bar Wahbun (†1193) 	ܝܘܚܢܢ, ܬܐܘܕܘܪܘܣ	216	auteur		
Théodore de Mopsueste (4-5 s.)		780	Auteur / Saint		
Théodore, martyr d'Euchaïta (†304) 			Saint		
Théodoret de Cyr (†ca.460)		781	Auteur		
Théodose (9 s.)			Copiste supposé		
Théodose d'Alexandrie (7 s.)	ܬܐܘܕܘܣܝܘܣ	784	auteur		
Théodose d'Antioche (†896) 	ܬܐܘܕܣܝܘܣ	169	Auteur		
Théodose de Jérusalem (6 s.) 					
Theodoṭa la Courtisane (†318)	ܬܐܘܕܘܛܐ ܙܢܝܬܐ		Sainte		
Théodote d'Amid († 698)			Saint		
Théodotos de Mardin (16 s.)			Autre		
Theonila (3-4 s.) 	ܬܐܘܢܝܠܐ		Sainte		
Théophile	ܬܐܘܦܝܠܐ		Propriétaire précédent 		
Théophile	ܬܐܸܘܿܦܝܼܠ݃ܐ		Auteur		
Théopiste, disciple de Dioscore d'Alexandrie		Needs ID	Attribué à		
Thomaïs de Nisibe (4 s. ?)	Supérieure de couvent Biographe de Fébronia	Needs ID	Attribué à	Cf. Damas 12/18	
Thomas 	ܬܐܡܐ	Needs ID	Auteur	cf. Paris BnF syr. 195	
Thomas a Kempis (14-15 s.)	ܬܘܡܐ ܕܟܡܒܝܣ	Needs ID	Auteur		
Thomas de Ḥarqel (7 s.)	Thomas d'Héraclée, ܬܘܡܐ	87	auteur		
Thomas de Karusaleš	ܬܐܘܡܐ		Copiste supposé		
Thomas de Kfartab 		Needs ID	Auteur	cf. Paris BnF syr. 225	
Thomas le diacre (6 s.)	ܬܐܘܡܐ	83	auteur		
Thomas, apôtre (1 s.)	ܬܐܘܡܐ		Saint		
Timothée (17 s.)	(Métropolite d'Amid)*  ܛܝܡܬܐܘܣ		Copié du temps de		
Timothée (19 s.) 	Paul d'Édesse   ܛܝܡܬܐܘܣ		Propriétaire précédent		
Timothée d'Alexandrie (†384)	ܛܝܡܘܬܐܣ	792	auteur		
Timothée de Birtha 	ܛܝܡܘܬܐܣ Jean de Birtha 	Needs ID	Auteur / attribué à	cf. Paris BnF syr. 177	
Ṭimotheos Isḥaq	ܛܝܡܬܐܘܣ ܡܦܪܝܢܐ ܕܗܘ ܐܝܣܚܩ  Maphrien Timothée 	Needs ID	Auteur		
Ṭiṭus bar Dawid bar Turkan bar Abunaṣer du monastère de Qayuma (13 s.) 	ܛܝܛܘܣ ܒܪ ܕܘܝܕ ܒܪ ܬܘܪܟܢ ܒܪ ܐܒܘܢܨܪ		Copiste 2		
Ṭobo	ܛܒܐ		restaurateur		
Tosius, Martin (17 s.)			Copiste		
Urie	ܐܘܪܝܐ		Saint		
Vansleb, Johann Michael (†1679)			Propriétaire précédent		
Villefroy (18 s.)			Propriétaire précédent		
Vosté, Jacques-Marie	ܝܥܩܘܒ ܒܘܣܬܐ		Propriétaire précédent		
Warda bar Lazare (17 s.)	 ܘܪܕܐ ܒܪ ܠܥܙܪ		Copiste		
Warda bar Muše de Mar-Ézéchiel (16 s.)	 ܘܪܕܐ		Propriétaire précédent		
Widmanstadt Johann Albrecht (16 s.)			Imprimeur		
Xénophon de Constantinople (6 s.)	ܟܣܢܦܘܢ		Saint		
Xvarr-veh-zâd (6-7 s.)			Destinataire		
Xyste I de Rome (2 s.)	ܟܣܘܣܛܘܣ Sixte 	22	Auteur		
Yalda bar 'Ebedyešu' bar Ḥadbešaba bar Israel (18 s.)	ܝܰܠܕܐܒܪܥܒܕܝܫܘܥܒܪܚܕܒܫܒܐܒܪܝܣܪܝܠ		Copiste		
Ya'qub 	ܝܥܩܘܒ		autre		
Ya'qub (16 s.)	ܝܥܩܘܒ, Jacques		copiste		
Ya'qub (19 s.)	ܝܥܩܘܒ	Needs ID	Auteur		
Ya'qub bar 'Abd al-Masiḥ de Mossoul (17 s.)	ܝܥܩܘܒ		copiste	cf. Paris BnF syr. 419	
Ya'qub bar Abraham de Bet Deyoqo	ܝܥܩܘܒ		Propriétaire précédent		
Ya'qub bar Bayram (16 s.)	ܝܥܩܘܒܒܪܒܝܪܡ		Propriétaire précédent		
Ya'qub bar Ḥanu Ya'qub Šamsuko et Barbara sœur d'Ibrahim (fin 19 s.)	ܝܥܩܘܒ		famille du copiste		
Ya'qub bar Mikail (11 s.)	Jacques, ܝܥܩܘܒ		commanditaire		
Ya'qub bar Yuḥanon (11 s.)	ܝܥܩܘܒ, Jacques		Fils du propriétaire précédent		
Ya'qub de Mardin (16 s.)	Jacques, ܝܥܩܘܒ		autre		
Ya'qub de Sainte-Marie-des-Syriens (15 s.)	Jacques, ܝܥܩܘܒ		copiste		
Ya'qub du monastère des Syriens (16 s.)	ܝܥܩܘܒ, Jacques		autre		
Ya'qub ibn Yussif QMG de Bet-Sahrya (19 s.)	Ya'qub bar Yawsep, ܝܥܩܘܒ 		Propriétaire précédent		
Yaret l'Alexandrin (3 s. ?)	ܝܪܬ		Saint		
Yawnan	ܝܘܢܢ		Saint		
Yawnan bar Giwargis (16 s.)	Jonas		Copiste		
Yawnan bar Isḥaq (19 s.)	Jonas ܝܘܢܢ		Annotateur		
Yawnan de Mar-Bišoy (16 s.)	Jonas ܝܘܢܢ		Copiste		
Yawsep	ܝܘܣܦ		Annotateur		
Yawsep (13 s. ?)	ܝܘܣܦ		commanditaire de restauration		
Yawsep (18 s.)	Joseph, Patriarche maronite d'Antioche, ܝܘܣܦ	Needs ID	Auteur		
Yawsep (19 s.)	Patriarche d'Orient  ܝܘܣܦܦܛܪܝܪܟܐܕܡܕܢܚܐ		Copié du temps de		
Yawsep (avant 17 s.)	évêque Joseph  ܝܘܣܦ	Needs ID	Auteur	cf. Paris BnF syr. 371	
Yawsep (Cyrille) de Ḥaḥ (15 s.)	ܝܘܣܦJoseph 		Annotateur		
Yawsep (fin 17 s.)	Joseph  ܝܘܣܦ	Needs ID	Auteur /lecteur		
Yawsep 'Azaria bar Yuḥanon de Telkef (fin 19 s.)	ܝܘܣܦ		Copiste		
Yawsep bar BLKZ	ܒܠܟܙ, ܝܘܣܦJoseph 		Propriétaire précédent		
Yawsep bar Ḥanu de Bet al-Gani (fin 19 s.)	 Joseph   ܝܘܣܦ		Copiste		
Yawsep bar Ḥanu Ya'qub Šamsuko et Barbara sœur d'Ibrahim (fin 19 s.)  	ܝܘܣܦ ܒܪ ܚܢܘ ܝܥܩܘܒ ܫܡܣܘܟܐ ܘܒܪܒܪܐ ܚܬܗ ܕܐܒܪܗܝܡ 		Copiste		
Yawsep bar Mikail frère d'Emmanuel bar Yawsep frère de Basilios bar 'Abdallah bar Denka de Bet Asmar (19 s.)	    Joseph, ܝܘܣܦ ܒܪ ܡܝܟܐܝܠ ܐܚܘܗܝ ܕܡܪܝ ܥܡܢܘܐܝܠ ܒܪ ܝܘܣܦ ܐܚܘܗܝ ܕܡܪܝ ܒܣܝܠܝܘܣ ܒܪ ܥܒܕܐܠܗ ܒܪ ܕܢܟܐ ܡܢ ܕܒܝܬ ܐܣܡܪ  		Copiste		
Yawsep bar Quriaqos (14 s.)	Joseph ܝܘܣܦ ܒܪ ܩܘܪܝܩܘܣ		Propriétaire précédent		
Yawsep bar Šlimon de Mar-Sargis (13 s.)	Joseph   ܝܘܣܦ		Autre		
Yawsep bar Tawma (16 s.)	Jospeh, ܝܘܣܦ		autre		
Yawsep bar Tawma bar Saipo bar Peṭros de Bet Abuna (19 s.)	ܝܘܣܦܒܪܬܐܘܡܐܒܪܣܝܦܐܒܪܦܛܪܘܣܕܒܝܬܐܒܘܢܐ		Copiste		
Yawsep bar Yuḥanon (13 s.)	Joseph, ܝܘܣܦ		autre		
Yawsep d'Abu Galib (fin 12 s.)  	   Cousin de Ṣaliba de Mar Barṣawma  ܝܘܣܦ		Copiste		
Yawsep Dadišo' (20 s.)	Joseph, ܝܘܣܦ ܕܕܝܫܘܥ, Supérieur général des monastères chaldéens		Copié du temps de..		
Yawsep de Ḥiṣn Kifa (11 s.)	ܝܘܣܦ Joseph		Copiste		
Yawsep de Mar-Mattaï (13 s.)	ܝܘܣܦ, Joseph		commanditaire		
Yawsep de Mélitène (11-12 s.)	ܝܘܣܦ Joseph		Enlumineur		
Yawsep de Ṭabayata (17 s.)	Joseph  ܝܘܣܦܡܢܛܒܝܬܐ		Propriétaire précédent		
Yawsep de Telkef (19 s.)	ܝܘܣܦ		Copiste		
Yawsep du Ṭur 'Abdin (15 s.)	Joseph, ܝܘܣܦ		Copiste 2		
Yawsep Eliya Kayyat (19-20 s.)	 Métropolite de Nisibe ; administrateur du patriarcat de Babylone ܝܘܣܦ ܐܠܝܐ ܟܲܝܵܐܛ ܒܲܒܼܠܵܝܵܐ		Commanditaire ; copié du temps de..		
Yawsep II de Telkef (fin 17 s.)	ܝܘܣܦ, Joseph, Patriarche des Chaldéens	818	Auteur		
Yawsep III (18 s.)	ܝܘܣܦ, Joseph, Patriarche des Chaldéens		Copié du temps de…		
Yawsep Peṭros (18 s.)	Patriarche d'Antioche, Joseph, ܝܘܣܦ	Needs ID	Auteur		
Yawsep, fils du tailleur babylonien (19 s.)	(Supérieur du monastère de Saint-Jacques à Alep)* ܝܘܣܦ		Copié du temps de		
Yawsep, roi des Mongols (15 s.)	ܝܘܣܦ		Propriétaire précédent		
Yazdin le Grand	ܝܙܕܝܢ	Needs ID	Auteur		
Yoaqim (18 s.) 	ܝܘܐܩܝܡ		Copiste		
Yuḥanna al-Khuri (16 s.)			Copiste 2		
Yuḥanna al-Zurbabi de Damas (17 s.)	ܝܘܚܢܐ ܐܠܙܪܒܐܒܝ	Needs ID	Auteur / Copiste		
Yuḥanna de Damas (16 s.) 	Jean, ܝܘܚܢܐ, Ibn-Ibrahim ben Ward		Propriétaire précédent		
Yuḥanna de Damas (17 s.)	 Jean ܝܘܚܢܐ ܐܠܣܪܝܐܢܝ ܐܠܫܐܡܝ		Copiste		
Yuḥanna de ŠDR' (17 s.)	ܝܘܚܢܐ, Jean		annotateur		
Yuḥanna de Zakhu (†1895)   	يوحنا		autre		
Yuḥanna ibn al-'Aziz	يوحنا, Grégoire		Propriétaire précédent		
Yuḥanna ibn Makhluf (17 s.)	ܝܘܚܢܐ, Jean, Patriarche		autre		
Yuḥanna ibn Manṣur ibn-Jebara	ܝܘܚܢܐ Jean		propriétaire précédent		
Yuḥanna ibn Masawayh (†857)	Jean, ܝܘܚܢܐ ܡܐܣܘܗ	Needs ID	auteur	cf. Paris BnF syr. 065	
Yuḥanna ibn Ya'qub ibn 'Isa ibn Sa'id ibn Qandil	Jean, ܝܘܚܢܐ		Propriétaire précédent 		
Yuḥannan bar Bakkos (13 s.)	ܝܘܚܢܢ ܒܪ ܒܟܘܣ		Copiste		
Yuḥanon 	Jean, ܝܘܚܢܢ		Propriétaire précédent		
Yuḥanon (11 s.)	ܝܘܚܢܢ  Jean		Propriétaire précédent 		
Yuḥanon (12-13 s.) 	Jean ; Métropolite d'Édesse ܝܘܚܢܢ		Illustrateur / ayant participé à la confection du manuscrit / annotateur / Copié du temps de…		
Yuḥanon (13 s.)	ܝܘܚܢܢ, Jean, Saru, ܣܪܘ		copiste		
Yuḥanon (13 s.)	(Patriarche d'Égypte)* Jean ܝܘܚܢܢ		Copiste / Copié du temps de 		
Yuḥanon (14 s.) 	Jean, Patriarche d'Alexandrie, ܝܘܚܢܢ		Copié du temps de 		
Yuḥanon (16 s.)	Jean, ܝܘܚܢܢ, Patriarche d'Alexandrie		Copié du temps de…/ Copiste 2		
Yuḥanon (après 12 s.)	ܝܘܚܢܢ  Jean	Needs ID	Auteur /lecteur		
Yuḥanon (fin 13 s.)	Jean  ܝܘܚܢܢ		Restaurateur		
Yuḥanon Abu-Ṣalibi (17 s.)	Jean, ܝܘܚܢܢ		commanditaire		
Yuḥanon 'Adinya (†1633)	ܝܘܚܢܢ ܥܕܝܢܝܐ ,Jean d'Ehden Patriarche maronite d'Antioche 		Copié du temps de…		
Yuḥanon bar Bayru	ܝܘܚܢܢܒܪܒܝܪܘ		Commanditaire		
Yuḥanon bar Dawid (13-14 s.)	Jean, ܝܘܚܢܢ		annotateur		
Yuḥanon bar Ḥasan (16 s.)	ܝܘܚܢܢ, al-Ṣufi		copiste		
Yuḥanon bar Hormizd de Bet Pelet, de Telkef (19 s.) 	ܝܘܚܢܢ ܒܪ ܗܘܪܡܙ ܡܢ ܕܒܝܬ ܦܠܬ		Propriétaire précédent 		
Yuḥanon bar Job (16 s.)	ܝܘܚܢܢ, Jean		copiste		
Yuḥanon bar Nagare	Jean, ܝܘܚܢܢ		saint		
Yuḥanon bar Ṭalia de Mazre'oio (fin 19 s.)	ܝܘܚܢܢ ܒܪ ܛܠܝܐ		Copiste 		
Yuḥanon d'Atil (fin 15 s.)	 Evêque d'Atil et des Boktoye   ܐܬܝܠ ܒܘ̈ܟܬܝܐ  Jean ܝܘܚܢܢ		Copié du temps de		
Yuḥanon de Bet 'Arbaye (12 s.)	ܝܘܚܢܢܕܒܝܬܥܖ̈ܒܝܐ		Copié du temps de…		
Yuḥanon de Chypre 	Jean, ܝܘܚܢܢ		Propriétaire précédent		
Yuḥanon de Ḥaṣrun (16 s.)	Jean, ܝܘܚܢܢ		autre		
Yuḥanon de Manṣur (16 s.) 	Yuḥanna, Jean, ܝܘܚܢܢ		copiste		
Yuḥanon de Mar-Gabriel-de-Qartmin (15 s.)	Jean, ܝܘܚܢܢ		lecteur		
Yuḥanon de QRQ'Š' (16 s.)	Jean, ܝܘܚܢܢ		autre		
Yuḥanon de Sarin Qasṭra (8 s.)	ܝܘܚܢܢ		copiste		
Yuḥanon du monastère des Syriens (16 s.) 	Jean, ܝܘܚܢܢ		autre		
Yuḥanon du Ṭur 'Abdin (15 s.)	ܝܘܚܢܢ, Jean		Copiste		
Yuḥanon Giwargis Sbirinoyo (15 s.)	ܝܘܚܢܢܓܘܪܓܝܣܣܒܝܪܝܢܝ		Copié du temps de		
Yuḥanon Me'amdana Raymundus (†1614)	ܝܘܚܢܢ ܡܥܡܕܢܐ ܪܐܝܡܘܢܕܘܣ, Jean Baptiste Raimondi, Giovanni Battista Raimondi		Commanditaire		
Yuḥanon Šešu (17 s.)	Jean ܝܘܚܢܢ ܫܫܘ		Copiste		
Yussif (fin 19 s.)	ܝܘܣܦ		Copiste		
Yussif Abu al-Karam	ܝܘܣܦJoseph 	Needs ID	Auteur 	cf. Paris BnF syr. 403	
Yussif al-Rabban (18 s.)	ܝܘܣܦ ܐܠܪܒܐܢ		Copiste 		
Yussif ibn 'Abd al-Masiḥ de DeirYa'qub (19 s.)	Joseph   ܝܘܣܦ ܐܒܢ ܥܒܕ ܐܠܡܣܝܚ		Lecteur		
Yussif ibn Ibrahim al-Madani	ܒܝܬ ܝܘܣܦ ܐܠܡܫܥܘܪ ܐܒܢ ܐܒܪܐܗܝܡ ܐܠܡܕܢܝ		Famille du copiste 		
Yussif ibn Maqdis Jibrail (après 18 s.) 	يوسف ابن مقدس جبرايل		Propriétaire précédent		
Yussif ibn Qas Uṣṭin (19 s.)	يوسف ابن قس وصطين		Propriétaire précédent		
Yussif ibn Ya'qub QMG ibn Yussif (19 s.)	ܝܘܣܦ, Joseph		Propriétaire précédent 		
Yuwanis	Jean, ܐܝܘܢܝܣ, Ṣaliba bar Tawma		autre		
Yuwannis bar Šem'un (16 s.) 	ܐܝܘܐܢܢܝܣ ܒܪ ܫܡܥܘܢ		Copiste		
Zacharie le Scholastique (6 s.)	Zacharie le Rhéteur , évêque de Mytilène 	58	Auteur		
Zakarya (12 s.)	 Zacharie ܙܟܪܝܐ		Autre		
Zakarya (14 s.)	Zacharie, ܙܟܪܝܐ		copiste du modèle		
Zakarya (fin 19 s.) 	ܙܟܪܝܐ		Autre		
Zakay	ܙܟܝ, Zachée		Autre		
Zaku (fin 19 s.)  	ܙܟܘ		Autre		
Zaytun al-Naḥlani	ܙܝܬܘܢ ܐܠܐܢܚܠܐܢܝ		Propriétaire précédent		
Zaytun de Kfarze (19 s.)	ܙܝܬܘܢܕܟܦܪܙܐ		Copiste		
Zénon le minime bar Soliman bar Abu Salem	ܙܝܢܘܢ ܒܪ ܣܘܠܝܡܢ ܒܪ ܐܒܘܣܠܡ		Copiste		
Zosime	ܙܘܣܝܡܘܣ		Saint		
Zotenberg Hermann (1834-1909)			Copiste		